id,name,brand_name,price,Origin,category,original_price,discount,discount_rate
270494125,Cốc giữ nhiệt inox 304 Elmich EL8300G dung tích 420ml,Elmich,299250,Trung Quốc,Bình/ Ly giữ nhiệt,480000,180750,38
18797709,Nệm Cao Su Non Gấp 3 ( 1m8x2mx10cm ) ,Happy,950000,Việt Nam,Nệm và phụ kiện,950000,0,0
217148812,Đèn Bàn Học LED RG0 Tamayoko 3 Chế Độ Ánh Sáng Bảo Vệ Mắt Chống Cận Thị Không Phát Xạ Ánh Sáng Xanh Model TB-55S/SW,Tamayoko,950000,Trung Quốc,Đèn học và đọc sách,985000,35000,4
193207962,Chảo vân đá đáy từ Nagakawa NAG2406 (24cm) - Nhôm nguyên khối - Dùng cho mọi loại bếp - Hàng chính hãng,Nagakawa,257000,Trung Quốc,Nồi và chảo,440000,183000,42
214789316,"Bàn để ủi, cầu là quần áo dạng đứng với khung bằng thép thêm tấm lót thay thế LEBENLANG LBL3636 - hàng chính hãng",Lebenlang,639000,Trung Quốc,Phụ kiện giặt ủi,959000,320000,33
259514009,"Muỗng Đong Định Lượng Greenhome, 2 Đầu, Chia Vạch Sẵn, Tiện Lợi, Đong Phân Bón Dạng Bột, Gia Vị",Greenhome,1500,Việt Nam,"Hoa tươi, Cây cảnh & Hạt giống",1500,0,0
83412126,Bình Giữ Nhiệt Lock&Lock Energetic One-Touch Tumbler LHC3249 - 550ML,LocknLock,273000,Trung Quốc,Bình/ Ly giữ nhiệt,528000,255000,48
262300577,Bình giữ nhiệt Sling Ring Tumbler LocknLock LHC4321IVY - Dung tích 650ml - Màu IVY,LocknLock,334000,Trung Quốc,Bình/ Ly giữ nhiệt,630000,296000,47
271539474,"Bộ hộp cơm giữ nhiệt Pump vacuum lunch box LocknLock LHC8052S02B - 5pcs (3 hộp, 1 túi, 1 bộ muỗng đĩa) - Màu",LocknLock,770000,Trung Quốc,Bộ hộp cơm và phụ kiện,1490000,720000,48
73124602,Bình Giữ Nhiệt Bằng Thép Không Gỉ Lock&amp;Lock Vacuum Bottle LHC6180FU (800ML),LocknLock,339000,Trung Quốc,Bình/ Ly giữ nhiệt,677000,338000,50
273170621,"Thùng Rác Treo Tủ Bếp Có Nắp Đậy Thông Minh, Thùng Rác Treo Tường Dán Tường Có Thanh Treo Cửa Tủ Bếp FEIDASH - Hàng Chính Hãng",feidash,136000,Trung Quốc,Dụng cụ vệ sinh,280000,144000,51
272671450,Bình giữ nhiệt Inox 304 ELMICH dung tích 480ml EL8296B/W - Hàng Chính Hãng,Elmich,188000,Trung Quốc,Bình/ Ly giữ nhiệt,515000,327000,63
275451439,BÁT ÚP MÌ INOX 304 ELMICH EL8314 DUNG TÍCH 1.35L,Elmich,135000,Trung Quốc,"Tô, chén, dĩa",250000,115000,46
214865436,"Tủ Để Đồ Có Nắp Đậy HÀNG NHẬP TRUNG ĐẸP XỊN Bằng Nhựa PVC Chống Ẩm Mốc Trong, Kệ Để Đồ Nhà Tắm Vệ Sinh Kèm Bánh Xe Linh Hoạt",VANDO,1099000,Trung Quốc,,2299000,1200000,52
248184506,"Combo 2 nắp bồn cầu thông minh dùng cơ Bumia bidet, tự rửa vệ sinh hậu môn và vệ sinh cho phụ nữ , vòi xịt vệ sinh thông minh, mã BM-01V",BUMIA,2879000,Việt Nam,Thiết bị phòng tắm,2879000,0,0
17423771,"5 Viên Pin CR2032 3V Panasonic Lithium thay pin Smartkey , Cmos , Pin thay Airtag - Hàng chính hãng",Panasonic,80000,Thái Lan/ Indonesia/Trung Quốc,Pin và dụng cụ sạc pin,100000,20000,20
85029511, Ổ cắm Điện Quang ĐQ ESK SM750SL (5 lỗ 3 chấu),Điện Quang,190000,,"Ổ cắm, ổn áp, biến áp",238684,48684,20
892121,Pin Max 8 + 4 Viên Energizer E91 BP8+4 AA,Energizer,144000,Singapore,Pin và dụng cụ sạc pin,144000,0,0
274957619,Bình giữ nhiệt Flexi Sunhouse 920 ml Sunhouse KS-TU920,Sunhouse,145000,Trung Quốc,Bình/ Ly giữ nhiệt,190000,45000,24
201040328,Bình giữ nhiệt LocknLock Riga Tumbler Vietnam Edition LHC4160 897ml,LocknLock,360000,Trung Quốc,Bình/ Ly giữ nhiệt,715000,355000,50
242435301,"Kệ Góc Nhà Bếp Khung Tròn INOX Cao Cấp Kệ Để Nồi Đa Năng Tiết Kiệm Không Gian VANDO, Kệ Để Xoong Nồi Đa Năng Nhà Bếp",VANDO,429000,Việt Nam,,856000,427000,50
193645848,Ấm đun nước inox cao cấp Smartcook 2.5L SM8280OL,Elmich,351500,Trung Quốc,,759000,407500,54
197590772,Dứa sấy dẻo 500 gam- nguyên vị 100% tự nhiên - ăn vặt siêu ngon - nông sản sạch,PAULEE,162000,Việt Nam,Phụ kiện phòng ăn,180000,18000,10
76541901,KHĂN TRẢI BÀN PAULEE 856B - HOA VĂN HỒNG - 150 CM X 264 CM - KHÔNG THẤM NƯỚC,PAULEE,189000,Đài Loan,Phụ kiện phòng ăn,210000,21000,10
273061077,"Tủ Để Chén Bát 3 Tầng Thông Minh VANDO Phiên Bản Mới Nhất, Tủ Chống Bụi Bẩn, Côn Trùng, Kèm Khay Hứng Nước Sạch Sẽ, Khô Ráo",VANDO,1199000,Trung Quốc,,1999000,800000,40
141246639,Hộp giữ nhiệt đựng đồ ăn có tay cầm Handle Food Jar LocknLock 700ml LHC8042NVY - Màu,LocknLock,420000,Trung Quốc,Dụng cụ chứa đựng thực phẩm,800000,380000,48
146432055,Túi Chân Không Tự Hút Đựng Chăn Mền Quần Áo Không Cần Dụng Cụ Hút,OEM,35000,Trung Quốc,Phụ kiện phòng ngủ,35000,0,0
273624233,Bình giữ nhiệt LocknLock Metro Two Way LHC4272/LHC4274 - Hàng chính hãng,LocknLock,302000,Trung Quốc,Bình/ Ly giữ nhiệt,605000,303000,50
186142362,Ô Dù Chống Nắng Che Mưa Cản UV Tự Động Đóng Mở Khung 12 Xương,NAVIVU,180000,Việt Nam,"Áo mưa, ô dù và phụ kiện đi mưa",180000,0,0
199728521,Bộ lau nhà đa năng Space Saving Sunhouse KS-CL3211PW,Sunhouse,235000,Việt Nam,Dụng cụ lau nhà,450000,215000,48
56880195,Bình nước Lock&Lock Eco Bottle ABF664BLU 750ml - Màu,LocknLock,122000,Trung Quốc,,242000,120000,50
180378151,Bình giữ nhiệt LocknLock Metro Drive LHC4277S 650ml - Kèm ống hút và cọ rửa,LocknLock,289000,Trung Quốc,Bình/ Ly giữ nhiệt,579000,290000,50
147265074,"Vỉ 2 VPin AA , Pin AAA DURACELL 1,5V Siêu Bền - Hàng chính hãng",DURACELL,30000,Trung Quốc,Pin và dụng cụ sạc pin,30000,0,0
7699066,"Chảo Nhôm Sâu Lòng Chống Dính Lock&Lock Baum Marble 1 Tay Cầm, Nắp Thủy Tinh LBU1305 (30cm)",LocknLock,438000,Trung Quốc,Nồi và chảo,879000,441000,50
275599590,Chảo Inox đa lớp Sunhouse IN20M6,Sunhouse,213000,Việt Nam,Nồi và chảo,352000,139000,39
207941719,Bộ cây lau nhà Lock&Lock Mini Spin Mop & 4 bông lau sàn ETM498MITS2 - Màu xanh mint,LocknLock,494000,Trung Quốc,Dụng cụ lau nhà,934000,440000,47
70820849,Pin CR2032 Energizer 3V vỉ 5 viên,Energizer,64600,Indonesia,Pin và dụng cụ sạc pin,64600,0,0
195852183,Bình giữ nhiệt bằng thép không gỉ LocknLock Jumbo Tumbler LHC4300NVY 900ML,LocknLock,382000,Trung Quốc,Bình/ Ly giữ nhiệt,730000,348000,48
275358388,Bình nhựa đựng nước LocknLock HAP814 - Dung tích 1.5L - Màu ngẫu nhiên,LocknLock,39000,Trung Quốc,,77000,38000,49
274823196,Ổ Cắm Điện Mở Rộng Xoay 180 Độ,NAVIVU,19900,Việt Nam,"Ổ cắm, ổn áp, biến áp",19900,0,0
73125530,Hộp cơm thủy tinh kèm muỗng đũa LocknLock LLG991CLNVY 930ml - Màu Navy,LocknLock,200000,Trung Quốc,Dụng cụ chứa đựng thực phẩm,362000,162000,45
52238368,Chiếu điều hòa cao cấp Ánh Sao - Sợi mây tổng hợp + Tặng kèm túi thơm thảo dược - giao mẫu ngẫu nhiên,A,120000,Việt Nam,Phụ kiện phòng ngủ,160000,40000,25
54097692,Pin Energizer 12V A23 BP1,Energizer,37700,Singapore,Pin và dụng cụ sạc pin,37700,0,0
275465197,Khăn Tắm Hải Cẩu BHN3 50x100cm,Mollis,64000,"Anh, Việt Nam",Khăn,64000,0,0
134360863,"Vỉ 6 Viên Pin AA , Pin AAA Energizer Max 1,5V Alkaline - Hàng chính hãng",Energizer,90000,Singapore,Pin và dụng cụ sạc pin,90000,0,0
275479886,"Xi Măng Dẻo Vá Tường, Bịt Kín Mọi Lỗ Hổng",NAVIVU,20000,Trung Quốc,Dụng cụ sửa chữa nhà cửa,20000,0,0
197852361,Ghế quầy bar gỗ không lưng tựa cao 75 cm chân cố định Ghế studio chụp ảnh đẹp CB Nemo-75W tại HCM,Capta,1380000,Việt Nam,Nội thất phòng ăn,1380000,0,0
274183101,Hộp bảo quản thực phẩm Smart Keep Fresh LocknLock - Không chứa BPA,LocknLock,59400,Hàn Quốc,Dụng cụ chứa đựng thực phẩm,119000,59600,50
57867023,Cây Lau Nhà Xoay 360 Độ Sunhouse Ks-Mo350I,Sunhouse,125000,Việt Nam,Dụng cụ lau nhà,200000,75000,38
210458939,"Đĩa Giấy Bạc Lót Nồi Chiên Không Dầu, Khay Bạc Nướng Thực Phẩm (Nhiều Cỡ)",NAVIVU,25000,Việt Nam,Phụ kiện nhà bếp,25000,0,0
892141,Pin Max 8 + 4 Viên Energizer E92 BP8+4 AAA,Energizer,144000,Singapore,Pin và dụng cụ sạc pin,180000,36000,20
99994000,Bình giữ nhiệt có ống hút Lock&amp;Lock Bucket Tumbler with Straw LHC4268NVY - Màu,LocknLock,247000,Trung Quốc,Bình/ Ly giữ nhiệt,473000,226000,48
271121025,"Bàn học sinh gấp gọn thông minh có khe máy tính bảng, khay để ly - chân bàn sơn tĩnh điện",PEAFLO,135000,Việt Nam,"Nội thất phòng học, làm việc",155000,20000,13
120552065,Bình giữ nhiệt inox 304 Elmich EL-8013OL dung tích 480ml,Elmich,157000,Trung Quốc,Bình/ Ly giữ nhiệt,389000,232000,60
3480627,Bộ Cây Lau Nhà Xoay Tay Compact Spin Mop Lock&Lock ETM466: Thùng Giặt + Cây + Bông Lau,LocknLock,489000,Trung Quốc,Dụng cụ lau nhà,924000,435000,47
275220446,"Khăn trải bàn PAULEE 856B nhựa PVC dẻo, không thấm nước",PAULEE,198000,Đài Loan,Phụ kiện phòng ăn,220000,22000,10
189568098,Bình giữ nhiệt inox 304 Elmich,Elmich,234650,Trung Quốc,Bình/ Ly giữ nhiệt,499000,264350,53
76541901,KHĂN TRẢI BÀN PAULEE 856B - HOA VĂN HỒNG - 150 CM X 264 CM - KHÔNG THẤM NƯỚC,PAULEE,189000,Đài Loan,Phụ kiện phòng ăn,210000,21000,10
197598280,Khăn trải bàn PAULEE WLG-751 hoa văn nhũ vàng (152cm x 228cm),PAULEE,237000,Đài Loan,Phụ kiện phòng ăn,250000,13000,5
197590772,Dứa sấy dẻo 500 gam- nguyên vị 100% tự nhiên - ăn vặt siêu ngon - nông sản sạch,PAULEE,162000,Việt Nam,Phụ kiện phòng ăn,180000,18000,10
101995256,Thanh Xốp Chắn Khe Cửa Đa Năng Thông Minh,PEAFLO,23000,Việt Nam / Trung Quốc,Bảo vệ nhà cửa,45000,22000,49
114204741,Bình giữ nhiệt inox 304 Sunhouse 450ml KS-TU450I,Sunhouse,100000,Việt Nam,Bình/ Ly giữ nhiệt,150000,50000,33
2119169,Bộ Cây Lau Nhà Lock&Lock Squeeze Flat Mop ETM471,LocknLock,496000,Trung Quốc,Dụng cụ lau nhà,979000,483000,49
247298318,"Áo Mưa Một Người Trong Suốt Có Nón Thời Trang, Nhựa EVA Sử Dụng Nhiều Lần",NAVIVU,38000,Trung Quốc,"Áo mưa, ô dù và phụ kiện đi mưa",38000,0,0
173854188,Ổ cắm xoay gấp gọn Điện Quang ĐQ ESK RT,Điện Quang,27700,Việt Nam,"Ổ cắm, ổn áp, biến áp",35129,7429,21
275467611,"Giá Để Giày Dép Kèm Thanh Treo Đồ Chất Liệu Thép Carbon Kiểu Dáng Hiện Đại, Tiện Ích",VANDO,259000,Trung Quốc,,259000,0,0
252134180,"Giường xếp gấp gọn 4 chân đa năng SUMIKA 181, có nệm, 5 cấp độ điều chỉnh",Sumika,960000,Trung Quốc,Nội thất phòng ngủ,1580000,620000,39
276044976,"Giường xếp gấp gọn di động SUMIKA 386A, chiều rộng 90cm, khung thép, có bánh xe di chuyển",Sumika,1810000,Trung Quốc,Nội thất phòng ngủ,2700000,890000,33
72746066,"Giường nệm xếp gọn kiểu dáng Hàn Quốc SUMIKA 339A, chiều rộng 90cm, tải trọng 300kg",Sumika,2440000,Trung Quốc,Nội thất phòng ngủ,3500000,1060000,30
271485839,"Giường xếp gọn cao cấp SUMIKA 339B, chiều rộng 70cm, khung thép, có bánh xe di chuyển",Sumika,2200000,Trung Quốc,Nội thất phòng ngủ,3260000,1060000,33
73314056,Lọ xay tiêu cầm tay nắp viền inox 304 lọ thủy tinh Hobby Home Decor XT mẫu thon cao và mẫu thấp tùy chọn,Hobby Home Decor,56000,Trung Quốc,Phụ kiện nhà bếp,98000,42000,43
272638497,Hộp bảo quản thủy tinh LocknLock BLANC - Hộp chữ nhật,LocknLock,61600,Trung Quốc,Dụng cụ chứa đựng thực phẩm,112000,50400,45
696349,Ổ Cắm Điện 4 Lỗ 3 Chấu 3m Philips SPN1248WB/74 (2500W),Philips,249000,Trung Quốc,"Ổ cắm, ổn áp, biến áp",299000,50000,17
274067031,Ổ cắm điện Philips CHP1130WB - 3m,Philips,82000,Trung Quốc,"Ổ cắm, ổn áp, biến áp",99000,17000,17
274867163,"Đất Trồng Cây Greenhome, Viên Nén 500gr, Đã Qua Xử Lý, Bổ Sung Vi Sinh, Nở Gấp 5 Lần, Trồng Rau Hoa",Greenhome,15900,Việt Nam,"Hoa tươi, Cây cảnh & Hạt giống",30000,14100,47
223727572,"[Chính Hãng]Keo Chống Thấm TAIKO Trong Suốt Silicon 10 Kg -Chống Thấm Gạch Lát Nền,Trần, Tường, Cửa Sổ, Vết Nứt Mái Nhà Triệt Để - Keo sau 72h mới khô hoàn toàn",TAIKOMI,1239767,Việt Nam,"Sơn, dầu mỡ, hóa chất",1458550,218783,15
275367488,Bình giữ nhiệt inox 304 Elmich EL8295 dung tích 500ml,Elmich,188000,Trung Quốc,Bình/ Ly giữ nhiệt,390000,202000,52
249022286,"Sơn Chống Thấm Đa Năng Gốc Bitum TAIKO BITSUN NO 2 - Keo Sơn Chống Thấm Bể Cá Koi, Sàn Mái Nhà, Móng Nhà, Bể Âm",TAIKOMI,165000,Việt Nam,"Sơn, dầu mỡ, hóa chất",250000,85000,34
270140718,"Thang nhôm rút gọn SUMIKA SKB380 - Chiều cao tối đa 3,8m, chiều cao rút gọn 0.81m, tải trọng 300kg",Sumika,1510000,Trung Quốc,Thang nhôm,2200000,690000,31
273871676,"Thang nhôm ghế gia đình 4 bậc SUMIKA A104, chiều cao 94cm",Sumika,520000,Trung Quốc,,750000,230000,31
201225920,"Màn chụp, mùng chụp đỉnh vuông chân viền cao cấp Một Cửa, có thể gấp gọn, dễ dịch chuyển, mang đi hay cất giữ - Hàng chính hãng (Giao màu viền ngẫu nhiên)",FuNu,272000,Việt Nam,Phụ kiện phòng ngủ,291000,19000,7
11488920,Bình Giữ Nhiệt Lock&Lock RigaTumbler (Shanghai) LHC4160RED  897ml - màu Red,LocknLock,309000,Trung Quốc,Bình/ Ly giữ nhiệt,715000,406000,57
275367488,Bình giữ nhiệt inox 304 Elmich EL8295 dung tích 500ml,Elmich,188000,Trung Quốc,Bình/ Ly giữ nhiệt,390000,202000,52
275402730,"Bình Gas Bơm Bật Lửa Bluesky 5 Đầu Bơm Dung Tích 150gr/275ml Siêu Tiện Dụng, Bình Bơm Gas Bật Lửa Hàn Quốc",eData,58900,Hàn Quốc,"Bếp nướng, vỉ nướng",58900,0,0
271479108,"Vợt Muỗi 2 Trong 1 Điện Quang ĐQ EMR10 W - Vợt muỗi kiêm đèn bắt muỗi thông minh, tự động, Pin 1200 mAh, Bảo Hành 12 tháng",Điện Quang,159000,Trung Quốc,"Dụng cụ diệt chuột, côn trùng",191614,32614,17
186558014,Combo 10 Móc Dán Tường Treo Đồ Đa Năng Siêu Chịu Lực,NAVIVU,20000,Việt Nam,,20000,0,0
99621372,Bình giữ nhiệt Lock&amp;Lock Belt Bottle LHC4267IVY490ml - Màu,LocknLock,247000,Trung Quốc,Bình/ Ly giữ nhiệt,473000,226000,48
274685975,Dù Gấp Mở Tự Động- Ô Che Mưa Gấp Gọn Mini Che Mưa 12 Nan Nhỏ Gọn Tiện Lợi,Mucar,139000,China / Vietnam,,139000,0,0
274942251,"Bàn học gấp gọn thông minh có khe cắm máy tính bảng, điện thoại - Hàng chính hãng",Nhà của Mẹ,171000,Việt Nam,"Nội thất phòng học, làm việc",180000,9000,5
54484578,Đèn Bàn Học LED USB Di Động Cao Cấp Có Thể Gập Hai Chỗ – 03 Chế Độ Ánh Sáng Vàng Bảo Vệ Mắt Chống Cận eLights - Đèn Cắm Dây,eLights,228000,Trung Quốc,Đèn học và đọc sách,228000,0,0
272913561,"Gel thông tắc sinh học AIKOMI vệ sinh cống, làm sạch đường ống, chậu rửa bát, nhà vệ sinh",Ximo,73500,Trung Quốc,Dụng cụ vệ sinh,75000,1500,2
274770054,Bình giữ nhiệt Metro studio tumbler LocknLock LHC4202BLK - Dung tích 470ml - Quai xách Silicone - Màu đen,LocknLock,354000,Trung Quốc,Bình/ Ly giữ nhiệt,668000,314000,47
192120961,Túi Zip Lụa Nhựa CPE Trong Mờ Có Khóa Kéo Đa Năng,NAVIVU,41000,Trung Quốc,Dụng cụ chứa đựng thực phẩm,41000,0,0
89774434,"Đèn cảm ứng chuyển động, Đèn Led dán tường cảm biến thông minh không dây dán tủ quần áo, cầu thang, phòng ngủ...",OEM,80000,Trung Quốc,,80000,0,0
274690181,"Cây Lau Bàn Bếp Tự Vắt Thông Minh Mini 25cm, Bọt Biển Siêu Thấm Hút Đa Năng, Gập Gọn",PEAFLO,51000,Hàn Quốc / Trung Quốc,Dụng cụ lau nhà,65000,14000,22
275060118,Áo Mưa Trùm Đầu Kiểu Poncho Không Che Đèn Xe,NAVIVU,180000,Trung Quốc,"Áo mưa, ô dù và phụ kiện đi mưa",180000,0,0
174236741,Găng tay cao su tự nhiên Lock&amp;Lock ETM830 (có móc treo),LocknLock,30800,Việt Nam,Dụng cụ vệ sinh,56000,25200,45
71890908,Bộ lau nhà xoay 360 độ Sunhouse KS-CL330S,Sunhouse,268400,Việt Nam,Dụng cụ lau nhà,406000,137600,34
159765477,Đầu vòi tăng áp 3 chế độ có đầu lọc cặn HOBBY Home Decor VSTA3 - vỏ trong suốt - hỗ trợ tăng áp lực 3 chế độ phun ( TẶNG KÈM REN NỐI VÀ ĐẦU LỌC),Hobby Home Decor,109000,Trung Quốc,Phụ kiện nhà bếp,159000,50000,31
189568098,Bình giữ nhiệt inox 304 Elmich,Elmich,213750,Trung Quốc,Bình/ Ly giữ nhiệt,499000,285250,57
187058674,"Ly Thủy Tinh Chịu Nhiệt Đựng Cà Phê Cold Brew, Sinh Tố và Các Loại Thức Uống Lạnh",NAVIVU,129000,Việt Nam,"Bình, ly uống cà phê và phụ kiện",129000,0,0
134515126,Bình giữ nhiệt cho cho trẻ em LocknLock Cozy Kids Straw Tumbler LHC4236PIK 330ml - Màu,LocknLock,253000,Trung Quốc,Bình/ Ly giữ nhiệt,592000,339000,57
273569921,Set 100 Túi Lưới Lọc Rác Bồn Rửa Chén,NAVIVU,14500,Trung Quốc,Dụng cụ vệ sinh,14500,0,0
58804363,Dụng Cụ Băm Rau Củ Quả Lock&amp;Lock Quick Chopper CKS308PIK,LocknLock,89000,Trung Quốc,Phụ kiện nhà bếp,171000,82000,48
51662145,"Keo dán siêu dính X2000 (50g) dán gỗ, sắt, sứ, kim loại đa năng",OEM,49100,Việt Nam,Dụng cụ sửa chữa nhà cửa,49100,0,0
55365176,0.5kg túi zipper chỉ đỏ đựng thực phẩm,Túi ni lông tự phân hủy sinh học GIMEX II,35000,Việt Nam,Dụng cụ chứa đựng thực phẩm,35000,0,0
275350239,"Chổi Quét Nhà Thông Minh Chổi Quét Nhà Xoay 180 Độ, Kèm Hót Rác Gấp Gọn Tiện Lợi - Hàng chính hãng (Giao màu ngẫu nhiên)",Gro-Fa,99000,Trung Quốc,Dụng cụ lau nhà,99000,0,0
45404047,"[ĐẶC BIỆT] Nhang Xanh Trầm Hương Cao Cấp 15 năm -100g - mùi thơm tự nhiên, dịu ngọt của trầm - Nhang Thiền",Nhang Xanh,125000,Việt Nam,,125000,0,0
261810715,Áo mưa cánh dơi vài dù siêu bền (loại dày 1.4m) - Giao màu ngẫu nhiên,PEAFLO,113000,Việt Nam,"Áo mưa, ô dù và phụ kiện đi mưa",135000,22000,16
25036394,Bình Lọc Nước Barrier Nika (2.5l) - Tím,BARRIER,80000,Nga,"Bình lọc, lõi lọc, thiết bị lọc nước",450000,370000,82
174489160,Găng tay thực phẩm phân hủy sinh học Sunhouse KS-PG290M,Sunhouse,17000,Việt Nam,Phụ kiện nhà bếp,21000,4000,19
103797681,"Mền nỉ, chăn nỉ mỏng ấm áp 1m6 x 2m cao cấp A thích hợp dùng đắp văn phòng, điều hòa",A,110000,Việt Nam,"Chăn, mền và phụ kiện",120000,10000,8
274957618,Bình giữ nhiệt Flexi Sunhouse 720 ml Sunhouse KS-TU72,Sunhouse,125000,Trung Quốc,Bình/ Ly giữ nhiệt,180000,55000,31
274541672,Drap Bọc Nệm Đủ Size ( Giao Màu Ngẫu Nhiên ),FUKOJI,59000,Việt Nam,,59000,0,0
127031393,Ca nước giữ nhiệt LocknLock Metro Mug LHC4219NVY 475ml - Màu Navy,LocknLock,266000,Trung Quốc,Bình/ Ly giữ nhiệt,506000,240000,47
3927949,"Bộ sạc Energizer Charger kèm 4 pin Ener AA 2000mAh, tự ngắt sạc (CHVCM4)",Energizer,446000,Trung Quốc,Pin và dụng cụ sạc pin,460000,14000,3
190320291,"Dụng Cụ Làm Vườn Greenhome, D25cm, Cán Gỗ, Lưỡi Thép, Gồm Xẻng Xúc Đất, Cào, Chĩa, Trồng Cây, Làm Cỏ Dễ Dàng",Greenhome,41900,Việt Nam,Dụng cụ làm vườn,70000,28100,40
274371739,Khăn Tắm Du Lịch Siêu Dày Có Thể Dùng Nhiều Lần,NAVIVU,15000,Trung Quốc,Khăn,15000,0,0
191918103,Dụng cụ rửa chai và ly LocknLock ETM143DGRY - Màu xám đen,LocknLock,42000,Trung Quốc,Phụ kiện nhà bếp,79000,37000,47
72615961,"Dây đèn led đom đóm trang trí decor phòng, du lịch cắm trại, fairy light cao cấp (tùy chọn loại nguồn cấp, chiều dài dây và màu sắc)",DEHA,14000,Trung Quốc,,23000,9000,39
272047595,Set 10 móc treo quần áo chống trượt xoay 360 đa năng ,PEAFLO,85000,HK/TQ,Phụ kiện giặt ủi,110000,25000,23
7903644,"Ổ Cắm Công Suất Lớn Điện Quang ĐQ ESKHP 3RW 2m ( 3 Lỗ, Màu Đỏ Trắng, Dây 2m)",Điện Quang,130000,Việt Nam,"Ổ cắm, ổn áp, biến áp",164198,34198,21
130767592,Ổ cắm Điện Quang ĐQ ESK SM740SL (4 lỗ 3 chấu),Điện Quang,151000,Việt Nam,"Ổ cắm, ổn áp, biến áp",198091,47091,24
576742,Bàn Laptop Gỗ Đức Thành - 22311 - Hàng Chính Hãng,Gỗ Đức Thành,429000,Việt Nam,"Nội thất phòng học, làm việc",525000,96000,18
1399571,Gối Memory Foam 50D Hình Cong Lock&Lock HLW111 (50 x 30 cm) - Trắng,LocknLock,254000,Trung Quốc,"Gối, ruột gối, vỏ gối",483000,229000,47
176741318,"Thùng Đựng Đồ Dùng , Đựng Thực Phẩm Đa Năng Trong Gia Đình Hokkaido Hàng Xuất Nhật Có Nắp Đậy Chốt Gài Thông Minh - Chính Hãng ( Tặng kèm khăn lau đa năng)",Inochi,129000,Việt Nam,Dụng cụ chứa đựng thực phẩm,198000,69000,35
177610565,Đèn Pin Siêu Sáng US ARMY Mã XML-T6 Cao Cấp Vỏ Hợp Kim Chống Nước Sử Dụng Pin Có Thể Sạc Lại Tặng Hộp Full Box- HÀNG CHÍNH HÃNG,US ARMY,99000,Nhật Bản / Trung Quốc,,198000,99000,50
110001215,"Nẹp Dây Điện Dán Tường Siêu Dính ,Kẹp Dây Điện Cố Định Và Giữ Dây Điện Siêu Sốc an toàn tiện lợi dễ lắp đặt",OEM,35000,Việt Nam,,35000,0,0
36935892,Combo 10 khăn lau bếp đa năng - KL29 (Giao ngẫu nhiên mẫu),OEM,10000,,Phụ kiện nhà bếp,11344,1344,12
101990592,"Thùng Đựng Gạo, Ngũ Cốc Thông Minh Kèm Cốc Vo Gạo",PEAFLO,219000,Việt Nam / Trung Quốc,,255000,36000,14
169978766,"Túi Hút Chân Không Đựng Quần Áo, Chăn Ga Gối, Thú Bông Deli - Loại Dày Cao Cấp, Nhiều Hoạ Tiết, Bảo Vệ Quần Áo, Chăn Ga Khỏi Ẩm, Nấm Mốc, Chống Nước Tuyệt Đối",Deli,14900,Trung Quốc,Phụ kiện phòng ngủ,26820,11920,44
162548473,Hộp Đựng Giày Nhựa Cứng Cao Cấp Size Lớn Cửa Nam Châm Lắp Ráp Tiện Lợi Song Anh- Hàng Chính Hãng,Song Anh,85000,Việt Nam,Nội thất phòng khách,85000,0,0
203003586,Vòi rửa chén đầu tăng áp thân uốn cong inox 304 Hobby Home Decor LXL,Hobby Home Decor,248900,Trung Quốc,Phụ kiện nhà bếp,262000,13100,5
275361313,Ổ Khóa 4 Số Có Đổi Mã Chữ U - Hàng nhập khẩu,ratoff-ars,155000,China,Bảo vệ nhà cửa,155000,0,0
203757099,Ổ Cắm Điện Du Lịch Quốc Tế Đa Năng Tích Hợp 3 Cổng USB-A 1 Cổng USB C. Chất Liệu Nhựa PC Chống Cháy Phù Hợp Với Hơn 150 Nước. Hàng Chính Hãng Tamayoko,Tamayoko,297000,Trung Quốc,"Ổ cắm, ổn áp, biến áp",299000,2000,1
68413077,"Đèn đọc sách mini, pin sạc tiện dụng Baseus Comfort Reading Mini Clip Lamp ( Dịu mắt, chân kẹp, 3 mức sáng, 350mAh, 24h sử dụng)hàng nhập khẩu",Baseus,215000,HK/TQ,,219000,4000,2
657076,Màng Bọc Thực Phẩm PE Ringo 150 (30cm x 150m),RINGO,103000,Việt Nam,Phụ kiện nhà bếp,103000,0,0
275569536,"Bao Ngón Tay Cao Su Tăng Độ Bám, Kháng Khuẩn, Dùng Được Cảm Ứng",NAVIVU,25000,Trung Quốc,Phụ kiện nhà bếp,25000,0,0
201363811,Khăn Tắm Bông San Hô (70x140cm) Mềm Mại Êm Ái Thấm Hút Tốt Và Nhanh Khô - Hàng Chính Hãng (Giao Màu Ngẫu Nhiên),lilahome,99000,Trung Quốc,Khăn,169000,70000,41
138144975,Màng nhôm (giấy bạc) Laspalm chính hãng bảo quản thực phẩm MNTP00003179,Las Palms Mission,24700,Việt Nam,Phụ kiện nhà bếp,48400,23700,49
56737810,Lô 4 Cuộn Túi Rác Tự Hủy Có Quai Tiện Dụng SOJI INOCHI Nhật Bản - Nhiều Màu - Nhiều Size - Đa dạng công năng sử dụng,Inochi,75000,Việt Nam,Dụng cụ vệ sinh,75000,0,0
275507815,"Khăn Cotton Dùng Một Lần Lau Mặt, Tẩy Trang",NAVIVU,35000,Trung Quốc,Khăn,35000,0,0
271261509,Set 10 khăn lau bếp đa năng màu xám,PEAFLO,39000,Việt Nam,Phụ kiện nhà bếp,55000,16000,29
274887983,"Dụng cụ vệ sinh nhà cửa thông minh 2 trong 1, chổi quét dọn mini kèm đồ hốt rác giúp dọn sạch bụi bám trên máy tính, góc tủ, cửa sổ,... GROFA- giao màu ngẫu nhiên ",Gro-Fa,19000,Trung Quốc,Dụng cụ lau nhà,19000,0,0
74292490,Đèn Tích Điện Năng Lượng Mặt Trời Sunhouse SHE-6899S,Sunhouse,216000,Trung Quốc,Đèn ngoài trời,350000,134000,38
34994341,"Vòi xịt nước tăng áp thông minh rửa xe, tưới cây có đầu xoay thay đổi tia nước tiện lợi có chốt khóa cố định chống mỏi tay",OEM,47000,Trung Quốc,Dụng cụ làm vườn,47000,0,0
275835176,Bong bóng hoa cúc trắng họa mi bông mai hướng dương mặt cười trang trí sinh nhật ngày lễ,Diệp Linh,9000,Việt Nam,Trang trí nhà cửa khác,9000,0,0
275975783,"[Sạc Nhanh GaN 65W] Ổ Cắm Điện Du Lịch Quốc Tế Đa Năng Tamayoko Công Suất 2500W 4 Cổng USB-C, USB",Tamayoko,853000,Trung Quốc,"Ổ cắm, ổn áp, biến áp",1000000,147000,15
73638934,Chảo chống dính đáy từ Elmich 4703OL size 20cm,Elmich,170000,Việt Nam,Nồi và chảo,450000,280000,62
2119173,Cây Lau Nhà Dạng Xịt Nước Lock&Lock ETM472,LocknLock,281000,Trung Quốc,Dụng cụ lau nhà,539000,258000,48
146262084,Gối Ngủ Memory Foam NOOZ Ruột Gối Cao Su Non Giúp Nâng Đỡ Đốt Sống Cổ Chống Đau Vai Gáy Ngủ Sâu Hỗ Trợ Chống Trào Ngược Phù Hợp Với Mọi Tư Thế Nằm Vỏ Gối Tencel,NOOZ,299000,Trung Quốc,"Gối, ruột gối, vỏ gối",560000,261000,47
145762926,"Khăn tắm cho bé, Khăn mặt, khăn gội đầu cotton cao cấp Hanvico By Homemark sợi nhập khẩu Thổ Nhĩ Kỳ mềm mại thấm hút tốt",Hanvico,16500,Việt Nam,Khăn,39000,22500,58
249253399,Nồi 5 đáy Inox 304 Elmich Berlin,Elmich,361000,Việt Nam,Nồi và chảo,667500,306500,46
696457,Ổ Cắm Điện 4 Lỗ 3 Chấu 5m Philips SPN1248WC/74 (2500W),Philips,329000,Trung Quốc,"Ổ cắm, ổn áp, biến áp",369000,40000,11
247316420,Túi 20 Khăn Giấy Nén Hàn Quốc Cao Cấp Loại Dày 2 Lớp 20*20cm - Hàng Chính Hãng,lilahome,49000,Trung Quốc,Khăn,49000,0,0
46202190,Combo nhiều túi lưới giặt đồ cho máy giặt bảo vệ quần áo chống biến dạng chất lượng tốt dây kéo lưới mịn Polyester,OEM,54000,Trung Quốc,Phụ kiện giặt ủi,54000,0,0
186369626,"Bộ chuyển đổi / Phích cắm chuyển đổi 3 chân thành 2 chân, ổ cắm 3 chấu thành 2 chấu -Henrysa",HENRYSA Bạn của mọi nhà,28000,Trung Quốc,"Ổ cắm, ổn áp, biến áp",38000,10000,26
203219969,Thùng rác chữ nhật nắp bấm Sunhouse KS-TR12LP,Sunhouse,128000,Việt Nam,Dụng cụ vệ sinh,210000,82000,39
226036798,Bình Giữ Nhiệt LocknLock 550ml LHC3249,LocknLock,273000,Trung Quốc,Bình/ Ly giữ nhiệt,549000,276000,50
274781551,"Thanh treo đa năng treo rèm, treo khăn, treo quần áo không cần khoan tường",PEAFLO,69000,Hàn Quốc / Trung Quốc,Phụ kiện giặt ủi,110000,41000,37
193648057,Chảo xào inox cao cấp 3 lớp đáy liền Elmich Trimax EL-3796 size,Elmich,747960,Việt Nam,Nồi và chảo,989000,241040,24
182971940,Bình giữ nhiệt LocknLock có 2 nắp thay thế New Clip Tumbler 540ml LHC4279,LocknLock,234000,Trung Quốc,Bình/ Ly giữ nhiệt,520000,286000,55
189208326,"Thảm nhà tắm, nhà bếp siêu thấm nước, chống trơn trượt tối giản, hiện đại NAVIVU",NAVIVU,99000,Việt Nam,Phụ kiện nhà tắm,99000,0,0
194570463,"Găng Tay Cao Su Nấu Ăn, Làm Bếp, Dọn Dẹp Siêu Dai, Siêu Bền",NAVIVU,19000,Trung Quốc,Dụng cụ vệ sinh,19000,0,0
274085939,Ống Hút Muỗng Đầu Lọc Dài 15.5 - 21cm (Kèm Cọ Rửa),NAVIVU,25000,Trung Quốc,"Ly, cốc & phụ kiện ly",25000,0,0
218754553,Vòi rửa mặt lavabo KG11 tay gạt dùng cho nước lạnh loại đẹp cao cấp inox sus304 - Hàng chính hãng,KINGO,173000,Việt Nam,Thiết bị phòng tắm,225000,52000,23
275263278,"Thuốc diệt chuột, Kẹo diệt chuột tiêu diệt cả đàn chuột hàng Thái Lan",ratoff-ars,65000,Thái Lan,"Dụng cụ diệt chuột, côn trùng",65000,0,0
223727594,"[Chính Hãng]Keo Chống Thấm TAIKO Trong Suốt Silicon 500 ml -Chống Thấm Gạch Lát Nền,Trần, Tường, Cửa Sổ, Vết Nứt Mái Nhà Triệt Để - Keo sau 72h mới khô hoàn toàn",TAIKOMI,99509,Việt Nam,"Sơn, dầu mỡ, hóa chất",132500,32991,25
1657931,Vợt Muỗi Sunhouse SHE-E200 - Vàng,Sunhouse,81000,Việt Nam,"Dụng cụ diệt chuột, côn trùng",119000,38000,32
194465292,Bình giữ nhiệt LocknLock DIY Strap Tumbler LHC3283 350ml,LocknLock,241000,Trung Quốc,Bình/ Ly giữ nhiệt,489000,248000,51
164158123,Vỉ 2 Viên Pin Duracell CR2032 / CR2025 / CR2016 Lithium 3V - Hàng chính hãng,DURACELL,77000,Trung Quốc,Pin và dụng cụ sạc pin,80800,3800,5
95880690,Kệ đựng đồ dùng rửa chén có treo khăn dán tường Hobby home decor KRC4,Hobby Home Decor,189000,Trung Quốc,,189000,0,0
53202251,"Túi Hút Chân Không 1 Mặt Nhám Dạng Cuộn B2D Roll 15x500cm (Cuộn Dài 5M). Làm Từ Hạt Nhựa Nguyên Sinh Cao Cấp Tiêu Chuẩn Vệ Sinh ATTP, Không Chứa Chất Gây Ung Thư, Dùng Được Trong Lò Vi Sóng. Hàng Chính Hãng Chất Lượng Cao Cấp.",Spring Green Evolution ,27000,,Dụng cụ chứa đựng thực phẩm,27000,0,0
97817455,Bộ túi hộp cơm thủy tinh COBA'COOK. Gồm 3 hộp 400ml và 1 túi giữ nhiệt với 2 khóa kéo tiện dụng- CCR43BL,COBA'COOK,392000,Trung Quốc,Bộ hộp cơm và phụ kiện,560000,168000,30
194872171,"Combo 2 Hộp Vải ĐựngQuần Áo , Vật Dụng Có Thể Xếp Gọn Khi Không Sử Dụng - Chính Hãng GROFA",Gro-Fa,69000,Trung Quốc,Phụ kiện giặt ủi,69000,0,0
52310134,"Cân điện tử mini nhà bếp, cân thực phẩm nguyên liệu làm bánh, trà sữa tặng kèm móc treo siêu dính 10kg",OEM,59000,Trung Quốc,Dụng cụ làm bánh,59000,0,0
271123700,Bình giữ nhiệt LocknLock Daily Macaron LHC3292 - Nắp mở một chạm - Dung tích 480ML,LocknLock,243000,Việt Nam,Bình/ Ly giữ nhiệt,490000,247000,50
274410790,Bình giữ nhiệt LocknLock Daily Handle Tumbler LHC4330 - Có quai cầm - Nắp trượt,LocknLock,278000,Trung Quốc,Bình/ Ly giữ nhiệt,528000,250000,47
275143588,"Cây Lau Bàn Bếp Tự Vắt Thông Minh Mini GẤP GỌN 25CM Cây Lau Tự Vắt GẤP GỌN MINI, Bọt Biển Siêu Thấm Hút Đa Năng",PEAFLO,55000,Trung Quốc/ Hàn Quốc/ Việt Nam/ Philipin,Dụng cụ vệ sinh,75000,20000,27
275610465,Chảo Inox Nguyên Khối Sunhouse Desire DEM,Sunhouse,216000,Việt Nam,Nồi và chảo,590000,374000,63
272400903,Hộp cơm giữ nhiệt inox 304 Elmich EL8303 dung tích 2L - Hàng chính hãng,Elmich,817880,Trung Quốc,Bộ hộp cơm và phụ kiện,1699000,881120,52
36300228,"Bộ Móc treo chữ S, có 3 size chọn lựa",OEM,25000,Trung Quốc,Phụ kiện giặt ủi,25000,0,0
271188890,Bình pha trà kèm lưới lọc Hario 450ml (CHC-45T),Hario,568000,Nhật Bản,"Bình, ly uống trà và phụ kiện",635000,67000,11
10383629,"Ổ cắm Điện Quang ECO ĐQ ESK 2WR 62ECO (6 Lỗ 2 chấu, dây dài 2m, màu trắng đỏ)",Điện Quang,113000,,"Ổ cắm, ổn áp, biến áp",141080,28080,20
70840199,"Vá Canh Bằng Gỗ Nhãn Tự Nhiên - VAGOO - Làm Thủ Công Chống Thấm, Chống Ẩm Mốc, An Toàn Cho Sức Khoẻ",Vagoo,99000,Việt Nam,Phụ kiện nhà bếp,99000,0,0
191899124,Cuộn Giấy Lau Nhà Bếp Đa Năng GROFA Nhiều Cỡ - Hàng Chính Hãng ( Họa tiết ngẫu nhiên),Gro-Fa,69000,Trung Quốc,Phụ kiện nhà bếp,69000,0,0
198835734,"Kệ Mỹ Phẩm Dán Tường, Tủ Để Đồ Trang Điểm, Thuốc, Đồ Dùng Cá Nhân",PEAFLO,189000,"Việt Nam / Hàn Quốc / Ấn Độ / Trung Quốc,...",Phụ kiện phòng ngủ,255000,66000,26
406914,Thảm Lót Chân Carlmann 35x50cm CM100170 - Giao màu ngẫu nhiên,Carlmann,83700,Trung Quốc,Phụ kiện nhà tắm,177500,93800,53
275221810,Bình đựng nước trẻ em 450ml Hokori chống tràn có ống hút cho bé đi học đi chơi hàng Cao cấp việt nhật - HÀNG VIỆT NAM,Việt Nhật,99000,Việt Nam,,180000,81000,45
186554172,"Kệ Đựng Mỹ Phẩm , Đồ Trang Điểm Trong Suốt 4 Tầng 9 Ngăn , Có Ngăn Kéo Bền Đẹp - Hàng Chính Hãng",PaKaSa,127330,Trung Quốc,Nội thất phòng ngủ,196000,68670,35
175721669,{ Chọn Màu} Ly Nước Thần Kì Đổi Màu Theo Nhiệt Độ Tặng Kèm Ống Hút Và Khăn Lau PaKaSa - Hàng Chính Hãng,PaKaSa,79000,Trung Quốc,"Ly, cốc & phụ kiện ly",126400,47400,38
274610888,"Miếng Tẩy Vết Keo Dán, Kẹo Cao Su Không Làm Hại Bề Mặt",NAVIVU,19900,Trung Quốc,Dụng cụ sửa chữa nhà cửa,19900,0,0
164848242,"Chậu gội đầu tại giường cho người già, trẻ nhỏ, người bệnh... màu sắc giao ngẫu nhiên- Hàng chính hãng",Nhà của Mẹ,123500,Việt Nam,Phụ kiện nhà tắm,130000,6500,5
1611899,Vợt Muỗi Điện Quang ĐQ EMR02 WR - Trắng Phối Đỏ,Điện Quang,111000,Trung Quốc,"Dụng cụ diệt chuột, côn trùng",136300,25300,19
275425224,"Bếp hơ lá trầu cho mẹ và bé sau sinh, bếp điện mini 1000W ",Nhà của Mẹ,180500,China / Vietnam,Dụng cụ làm bánh,190000,9500,5
67980198,"Phân bón hữu cơ sinh học KingCrop, dùng trồng rau, cây ăn trái sạch, an toàn",KINGCROP,70000,Việt Nam,"Hoa tươi, Cây cảnh & Hạt giống",70000,0,0
191918105,Bộ Bàn Chải Vệ Sinh Các Khe LocknLock ETM415 - 2 cái/bộ,LocknLock,21400,Trung Quốc,Phụ kiện nhà bếp,39000,17600,45
275588709,Găng Tay Cao Su Y Tế Size L Không Bột Nitrile TTGLOVES Màu Xanh (100 Chiếc) ,TTGloves,90000,"Anh, Việt Nam",Dụng cụ vệ sinh,90000,0,0
114966666,Hộp Đựng Mỹ Phẩm Dán Tường 2 Tầng Kích Thước 28*10*34cm Chống Nước - Hàng Chính Hãng,PaKaSa,178500,Trung Quốc,Nội thất phòng ngủ,260000,81500,31
134360720,"Bộ 8 Pin AAA ( R03NT/2S ) Panasonic 1,5V Không Chì - Hàng Chính Hãng",Panasonic,40000,Indonesia,Pin và dụng cụ sạc pin,40000,0,0
11419635,Đèn Compact Điện Quang ĐQ-CFL-3U-T4-18W-DL-E27,Điện Quang,54700,Việt Nam,Bóng và linh kiện đèn,74383,19683,26
273804599,Lô 10 Găng Tay Nhà Bếp Nhựa PE/CPE Dài 60cm Có Thun,NAVIVU,30000,Trung Quốc,Phụ kiện nhà bếp,30000,0,0
275967425,Giỏ Đựng Quần Áo Đồ Dùng Gấp Gọn Việt Nhật Treo Tường (Giao màu ngẫu nhiên),Việt Nhật,89000,Việt Nam,Phụ kiện giặt ủi,115000,26000,23
205602038,Bộ 4 ly thủy tinh cao cấp Florian 430ml - Bormioli Rocco màu xanh - Italy,Bormioli Rocco,598000,Ý,"Bình, ly uống trà và phụ kiện",692000,94000,14
7220265,Nhang quế tự nhiên Kỳ Anh - NQ40,Trầm Hương Kỳ Anh,52000,,,52000,0,0
275521981,Túi vàng lá Thần Tài phong thủy sung túc tài lộc trang trí  - Hàng chính hãng,Gro-Fa,127000,Trung Quốc,Vật phẩm phong thủy,127000,0,0
275079365,"Bộ khay đựng đồ ăn dặm 6 món (khay, ly, bát, thìa, nĩa, đũa) cho bé bằng lúa mạch dễ thương, tiện dụng , an toàn- Hàng chính hãng (màu giao ngẫu nhiên)",Gro-Fa,91000,Trung Quốc,Phụ kiện nhà bếp,91000,0,0
273717652,Set 2 Miếng Cọ Sắt Chà Xoong,PEAFLO,25000,HK/TQ,Phụ kiện nhà bếp,45000,20000,44
120759154,"Bó 100 Dây Thít, Dây Rút, Lạt Nhựa Đủ Mọi Kích Cỡ Tiện Lợi",OEM,25000,Việt Nam,Dụng cụ sửa chữa nhà cửa,25000,0,0
275220683,"Bình nước thể thao, Bình nước chịu nhiệt 700ml Hokori Perfect thời thượng cao cấp nắp bật chống tràn - Chính Hãng Việt Nhật",Việt Nhật,99000,Việt Nam,,180000,81000,45
32021492,Ổ Khóa Số Du Lịch Stanley S742-054,Stanley,156000,Trung Quốc,Bảo vệ nhà cửa,167000,11000,7
68788547,Hộp đựng đồ đa năng có nắp - màu ngẫu nhiên,OEM,89000,Trung Quốc,Phụ kiện phòng ngủ,120000,31000,26
59412424,"Bộ Dụng Cụ Bếp (Đũa, Sạn, Vá) Bằng Gỗ Nhãn Tự Nhiên - VAGOO - Làm Thủ Công Chống Thấm, Chống Ẩm Mốc, An Toàn Sức Khoẻ",Vagoo,169000,Việt Nam,"Đũa, muỗng, nĩa",169000,0,0
134483225,Thảm Lót Chân Nhà Tắm Chống Trơn Trượt Hình Ô Vuông PaKaSa,PaKaSa,116620,Trung Quốc,Phụ kiện nhà tắm,180000,63380,35
52868472,Bộ 2 Hũ Thủy Tinh Có Tay Cầm 500ml KOVA HTC,KOVA,89100,Hàn Quốc,Dụng cụ chứa đựng thực phẩm,109000,19900,18
274953384,"Tỳ hưu phong thủy để bàn size lớn 11*6.5*10.5 cm trang trí không gian xe hơi, bàn làm việc - Hàng chính hãng",Nhà của Mẹ,228000,China / Vietnam,Vật phẩm phong thủy,240000,12000,5
19943595,Khăn Trải Bàn PAULEE - WB 605L (135 x 180 cm),PAULEE,178500,Trung Quốc,Phụ kiện phòng ăn,210000,31500,15
275841170,Kệ Mỹ Phẩm Xoay 360 Độ Để Bàn Có Nhiều Ngăn Đa Dụng,PEAFLO,95000,"Việt Nam / Hàn Quốc / Ấn Độ / Trung Quốc,...",Nội thất phòng khách,135000,40000,30
274663738,Tượng chú trâu vàng đế kính thủy tinh cao cấp - Trâu Vàng Kim Tiền - Hàng Nhập Khẩu,Tanix,550000,Trung Quốc,Vật phẩm phong thủy,550000,0,0
99868980,Bình Giữ Nhiệt Locknlock Bucket Tumbler 540ml LHC4269DPIK,LocknLock,247000,Trung Quốc,Bình/ Ly giữ nhiệt,473000,226000,48
53789448,"Bộ cây lau nhà tự vắt thông minh, chổi lau nhà 360 độ, lau sạch khô nhanh - Parroti Pro PR01",Parroti,379050,Trung Quốc,Dụng cụ lau nhà,399000,19950,5
274957621,Cốc giữ nhiệt Snappy 500 ml Sunhouse KS-TU500,Sunhouse,129000,Trung Quốc,Bình/ Ly giữ nhiệt,170000,41000,24
262362970,Ca giữ nhiệt Flat Table Mug LocknLock LHC4320 - Dung tích 730ml - Tay cầm thoải mái - Miệng ca rộng - Nắp trong suốt,LocknLock,284000,Trung Quốc,Bình/ Ly giữ nhiệt,540000,256000,47
58357614,"Đèn bắt muỗi, ruồi và các loại côn trùng Con Dơi",CON DƠI,390000,Việt Nam,,390000,0,0
76834277,Combo 2 Miếng Lau Nhà Thế Hệ Mới Parroti Pro PAD2-PR01 - Kích Thước 33 x12 CM (Chỉ dùng được cho Bộ lau nhà Parroti Pro),Parroti,79000,Trung Quốc,Dụng cụ lau nhà,79000,0,0
248420700,"Ổ Cắm Điện Đa Năng Có Công Tắc Nguồn 3/4/6 Ổ , 3M/5M Dây Chống Giật Chống Cháy Chất Lượng Cao Deli - Hàng Chính Hãng - ET401 - 406",Deli,135000,Trung Quốc,"Ổ cắm, ổn áp, biến áp",243000,108000,44
54686184,"Bạt Áo Trùm Máy Giặt Cửa Trên, Cửa Ngang Vải Dù Siêu Dày, Chống Thấm Nước, Không Phai Màu - (Giao Màu - Họa Tiết Ngẫu Nhiên)",XUDI,97000,,Phụ kiện giặt ủi,99999,2999,3
10591477,"Ổ cắm Điện Quang ECO ĐQ ESK 2WR 32 ECO (3 lỗ 2 chấu, dây dài 2m, màu trắng đỏ)",Điện Quang,73800,Việt Nam,"Ổ cắm, ổn áp, biến áp",99522,25722,26
206202845,Combo Khuyến Mãi Tặng Kèm Khi Mua Keo Sơn Chống Thấm TAIKO (KHÔNG BÁN),TAIKOMI,8000,Việt Nam,"Sơn, dầu mỡ, hóa chất",8000,0,0
134853381,Bình giữ nhiệt LocknLock Feather Light Ring LHC4244PIK 460ml - Màu,LocknLock,301000,Trung Quốc,Bình/ Ly giữ nhiệt,601000,300000,50
11291289,Ổ cắm du lịch Điện Quang ĐQ ESK TV01,Điện Quang,72000,Việt Nam,"Ổ cắm, ổn áp, biến áp",91331,19331,21
54130086,Cây lau nhà tự vắt thông minh đa năng cao cấp Parroti Magic MG01 - Tặng 1 Miếng Lau,Parroti,214700,Trung Quốc,Dụng cụ lau nhà,226000,11300,5
275261014,"Cây lau nhà tự vắt có thùng 2 ngăn Deli, Bộ chổi lau nhà 360 độ kèm 3 bông lau microfiber siêu sạch",Deli,45000,Trung Quốc,Dụng cụ lau nhà,81000,36000,44
186627908,"Ghế Gác Chân Công Thái Học Ergonomic Footrest, Ghế Kê Chân Ghế Gác Chân Văn Phòng",Office Chill,189000,Việt Nam,"Nội thất phòng học, làm việc",280000,91000,33
55900887,"Đèn Bàn Học Đọc Sách, Làm Việc (Học Sinh, Sinh Viên, Văn Phòng) LED Chống Cận, Cảm Ứng Nhôm Cao Cấp eLights",eLights,299000,,Đèn học và đọc sách,299000,0,0
273792609,"Máy Đuổi Chuột Thế Hệ Mới, Đèn Đuổi Muỗi Và Côn Trùng, Sử Dụng Sóng Siêu Âm, Xua Đuổi Côn Trùng",Gubix,259000,"Anh, Việt Nam","Dụng cụ diệt chuột, côn trùng",259000,0,0
272553617,"Túi bọc quần áo treo tủ chống bụi chống ẩm mốc Deli, Túi bọc trùm quần áo PEVA có khóa loài dày dặn, sắp xếp tủ quần áo",Deli,18000,Trung Quốc,Phụ kiện giặt ủi,32400,14400,44
56745997,Khăn Tắm Mollis Cotton 60x120cm Khăn Cao Cấp Mềm Mịn Thấm Hút Không Ra Màu Không Xù Đồ Lông Gia Đình Spa Khách Sạn B853,Mollis,125000,Việt Nam,,184000,59000,32
84566545,Ổ cắm điện đa năng kết hợp ổ cắm USB Nakagami chất lượng cao công nghệ Nhật Bản - Màu ngẫu nhiên,Nakagami,165000,Việt Nam,"Ổ cắm, ổn áp, biến áp",165000,0,0
116726951,"Gối cao su non công thái học chống đau vai ngáy, ngủ ngáy, hỗ trợ ngủ nhanh EMA- Thiết kế riêng biệt cho tư thế nằm ngửa và nằm nghiêng",Ema,299000,Trung Quốc,"Gối, ruột gối, vỏ gối",598000,299000,50
111472777,Miếng Dán Tường Đa Năng SenNai - Móc Dán Cây Lau Nhà Loại Tốt - Chịu Tải Lên Đến 5kg,SenNai Furnitures,18000,Việt Nam,,18000,0,0
20680352,Combo 5 bẫy diệt chuột thông minh,OEM,75000,,"Dụng cụ diệt chuột, côn trùng",75000,0,0
275511640,Chảo chống dính Elmich EL-4718OL,Elmich,144000,Việt Nam,Nồi và chảo,309000,165000,53
558335,Ổ Cắm Điện Có Nắp Che 5 Lỗ 2 Chân Mpower MP-153 - 3 Mét,Mpower,125000,Trung Quốc,"Ổ cắm, ổn áp, biến áp",125000,0,0
273084830,[Sạc Nhanh PD 35W] Ổ Cắm Điện Đa Năng Du Lịch Quốc Tế Tamayoko 5 Cổng Type-C & USB Cắm Tải 2000W,Tamayoko,489000,Trung Quốc,"Ổ cắm, ổn áp, biến áp",489000,0,0
35058677,Vỉ 5 Viên Pin CR1632 ( CR 1632/5BE x 1 Vỉ ) Panasonic Lithium 3 V - Hàng Chính Hãng,Panasonic,85000,Indonesia,Pin và dụng cụ sạc pin,85000,0,0
181223608,Bộ vòi xịt vệ sinh rửa toilet tăng áp inox 304 Hobby home decor VSR1 dây sen 1.2m,Hobby Home Decor,149000,Trung Quốc,Thiết bị phòng tắm,159000,10000,6
263239689,Pin kiềm AA Philips LR6P4B/97 vỉ 4 viên,Philips,37000,Trung Quốc,Pin và dụng cụ sạc pin,48000,11000,23
275451439,BÁT ÚP MÌ INOX 304 ELMICH EL8314 DUNG TÍCH 1.35L,Elmich,135000,Trung Quốc,"Tô, chén, dĩa",250000,115000,46
150898622,Thảm Lau Chân Chùi Chân Nhà Tắm KR02 chống trượt 3d nhà bếp welcome cao cấp giá rẻ khách sạn đế cao su hút nước,Shouse,39000,Trung Quốc,Phụ kiện nhà tắm,39000,0,0
275241205,"Băng keo chống thấm NHẬT BẢN Siêu Dính - Băng Dính Chống Thấm Nước Chống Dột Mái Tôn, Dán Tường",smatayoko,95000,Nhật Bản,Dụng cụ sửa chữa nhà cửa,95000,0,0
274368618,"Dép Nhà Tắm Cao Su EVA Chống Trượt, Siêu Nhẹ, Dẻo Dai",NAVIVU,37000,Trung Quốc,Phụ kiện nhà tắm,37000,0,0
79267304,"Túi rác tự hủy inochi tiện dụng SOJI có quai xuất nhật Dùng đựng rác gia đình ,Bao đựng rác văn phòng đủ size -màu đen mềm nhẹ dai túi rác tự hủy giúp bảo vệ môi trường",Inochi,79000,Việt Nam,Dụng cụ vệ sinh,79000,0,0
120481094,"Gối kê cổ chữ U cao su non EMA chống đau mỏi cổ vai gáy cho dân văn phòng, đi du lịch, tàu xe",Ema,79000,Trung Quốc,"Gối, ruột gối, vỏ gối",158000,79000,50
655378,Đèn Tích Điện Đa Năng 360 Cỡ Trung Sunhouse SHE-6848LA - Trắng,Sunhouse,206000,Trung Quốc,,331000,125000,38
169650796,"Màn chụp, mùng chụp đỉnh vuông Không chân viền cao cấp Một Cửa - Hàng chính hãng (Giao ngẫu nhiên)",FuNu,240350,Việt Nam,Phụ kiện phòng ngủ,253000,12650,5
275941052,Gói 30 Hạt Giống Rau Quế Chịu Nhiệt Tốt,Sen Vàng Seeds,2000,Việt Nam,"Hoa tươi, Cây cảnh & Hạt giống",2000,0,0
274721418,Ô Dù Che Mưa Đi Nắng Tự Động Xếp Gấp Gọn Chống UV Cao Cấp Cho Ô Tô Xe Hơi (phiên bản ĐẶC BIỆT 12 nan chịu lực),EVENDAY,149000,Hàn Quốc / Trung Quốc,,149000,0,0
56941523,Ly nhựa 2 lớp LocknLock kèm ống hút HAP507 750ml,LocknLock,108000,Trung Quốc,"Bình, ly uống trà và phụ kiện",217000,109000,50
157508710,Bộ chăn gối văn phòng 3 trong 1 hình thú dễ thương EMA kèm gối luồn tay giữ nhiệt - Tựa lưng - Ngủ trưa - Gối ôm,Ema,140000,Trung Quốc,"Gối, ruột gối, vỏ gối",280000,140000,50
215225085,"Set 2 Miếng Dán Bulong Ốc Vít, Treo Kệ, Treo Tranh Không Khoan Tường",NAVIVU,25000,Trung Quốc,Phụ kiện phòng ngủ,25000,0,0
158639945,"Hộp 20 Viên Pin AA / AAA Maxell Alkaline 1,5V - Hàng chính hãng",Maxell,130000,Thái Lan / Trung Quốc / Malaysia (Tùy từng đợt nhập hàng),Pin và dụng cụ sạc pin,130000,0,0
242696322,"Set 2 Miếng Dán Treo Ổ Điện, Giá Đỡ Dán Tường Hình Chữ Nhật",NAVIVU,25500,Trung Quốc,,25500,0,0
50241058,"Kệ sách gỗ để bàn - Tủ,kệ sách mini - Giao màu sắc ngẫu nhiên ",OEM,82000,Việt Nam,"Nội thất phòng học, làm việc",99000,17000,17
217574639,"Đế chống rung máy giặt KG23 chân máy giặt chân bàn 4 miếng cao su cao cấp, chống rung chống ồn chống trơn trượt (giao màu ngẫu nhiên) - Hàng chính hãng",KINGO,30000,Việt Nam,Phụ kiện giặt ủi,65000,35000,54
225960091,"Vòi xịt vệ sinh KG49 cao cấp, xịt nước mạnh rất êm siêu bền chất liệu inoxsus304 - Hàng chính hãng",KINGO,110000,Việt Nam,Thiết bị phòng tắm,140000,30000,21
57867024,Bộ Lau Nhà Xoay 360 Độ Sunhouse Ks-Cl350PO,Sunhouse,309760,Việt Nam,Dụng cụ lau nhà,513000,203240,40
272894944,"Vòi tắm hoa sen KG28 tăng áp 4in1 kèm đầu cọ massage 3 chế độ nước, đầu vòi có lõi lọc cao cấp tặng kèm dây sen 1m5- Hàng chính hãng",KINGO,115000,Việt Nam,Thiết bị phòng tắm,139000,24000,17
19920919,Bật Lửa Mồi Lửa Bếp Gas Bếp Cồn An Toàn (Màu Sắc Ngẫu Nhiên),OEM,28000,,"Bếp nướng, vỉ nướng",28000,0,0
274100175,Hũ thủy tinh Breathing LocknLock - Kèm nắp đậy - Tay cầm hủ linh hoạt,LocknLock,83600,Trung Quốc,Dụng cụ chứa đựng thực phẩm,146000,62400,43
12736380,Đồng hồ để bàn led báo thức thông minh,OEM,200000,Trung Quốc,Đồng hồ,200000,0,0
74329992,Hộp Đựng Trang Sức Nữ Trang Cỡ Lớn Da Cao Cấp,OEM,50000,Trung Quốc,Phụ kiện phòng ngủ,50000,0,0
275432559,Bộ Máy và kim Đồng Hồ treo tường Kim Trôi LOẠI TỐT,Rainy,59000,Đài Loan,Đồng hồ,59000,0,0
275427593,Đồng Hồ Pomodoro Hẹn Giờ 60 Phút Kim Loại Nhiều Kiểu Dáng,NAVIVU,105000,Trung Quốc,Đồng hồ,105000,0,0
94888985,Sọt Đựng Quần Áo Bẩn Túi Đựng Đồ Đa Năng,OEM,85000,Trung Quốc,Phụ kiện giặt ủi,85000,0,0
68078015,100 Túi Hút Chân Không Thực Phẩm Một Mặt Nhám Một Mặt Trơn,Shineye,120000,Trung Quốc,Dụng cụ chứa đựng thực phẩm,120000,0,0
204057050,"Ghế Công Thái Học Ergonomic Có Ngả Lưng Gác Chân TANNI Premium 02 Plus, Ghế Xoay Văn Phòng Gaming Cao Cấp Nhập Khẩu",TANNI,1137000,Đài Loan,"Nội thất phòng học, làm việc",2390000,1253000,52
272836397,Chăn Hè Cotton Đũi Hàn Quốc Hàng Loại 1 ( 2m3x2m )Mềm Siêu Mát Lạnh Mùa Hè - Hàng Chính Hãng MINIIN,MINIIN,135850,Trung Quốc,"Chăn, mền và phụ kiện",165000,29150,18
7699055,Chảo Nhôm Chống Dính Lock&Lock Baum Marble 1 Tay Cầm LBU1243C (24cm),LocknLock,249000,Trung Quốc,Nồi và chảo,451000,202000,45
7699062,Chảo Nhôm Chống Dính Lock&Lock Baum Marble 1 Tay Cầm LBU1283C (28cm),LocknLock,299000,Trung Quốc,Nồi và chảo,567000,268000,47
274967167,"Ổ cắm điện đa năng Deli Công Suất 2500W - Tích Hợp Ổ USB & Type C Thiết Kế Cầu Chì Tự Ngắt Khi Quá Tải, Nắp Chống Giật",Deli,249000,Trung Quốc,"Ổ cắm, ổn áp, biến áp",448200,199200,44
52885368,1 Kg túi zip chỉ đỏ thương hiệu Gimex II,Túi ni lông tự phân hủy sinh học GIMEX II,69000,,Dụng cụ chứa đựng thực phẩm,69000,0,0
275493793,Màng PE Bọc Nội Thất Chống Bụi Chống Nước Khi Thi Công,NAVIVU,20000,Trung Quốc,Dụng cụ sửa chữa nhà cửa,20000,0,0
274841797,"Bàn Học Gấp Gọn Có Khe Để Điện Thoại, Máy Tính Bảng, Khay Để Ly - Hàng Loại 1 (Giao ngẫu nhiên)",PEAFLO,133000,"Việt Nam / Hàn Quốc / Ấn Độ / Trung Quốc,...","Nội thất phòng học, làm việc",165000,32000,19
71005991,Bình xịt dầu Lock&Lock 100ml kèm phểu và cọ rửa - CKO109,LocknLock,95700,Trung Quốc,Dụng cụ chứa đựng thực phẩm,174000,78300,45
274680899,Hộp cơm điện hâm nóng và giữ nhiệt đồ ăn Yoice 2 tầng khay inox không gỉ thích hợp cho nhân viên văn phòng - HÀNG CHÍNH HÃNG,Yoice,489020,Trung Quốc,Dụng cụ chứa đựng thực phẩm,539000,49980,9
26334551,Mền dù cao cấp  - mỏng nhẹ - thoáng mát - Cho giấc ngủ dễ chịu [chăn ga gối đệm,A,160000,Việt Nam,"Chăn, mền và phụ kiện",180000,20000,11
58156247,"bao giày không thấm nước, chống trượt, ủng giày đi mưa siêu nhẹ",OEM,79000,Trung Quốc,"Áo mưa, ô dù và phụ kiện đi mưa",79000,0,0
249970010,Chảo inox 3 lớp Elmich EL-3846OL Size 24cm,Elmich,378100,Việt Nam,Nồi và chảo,599250,221150,37
558102,Bình Lọc Nước Barrier Grand Neo - BA-NEO-R - 4.2 Lít - Màu Đỏ,BARRIER,159000,Nga,"Bình lọc, lõi lọc, thiết bị lọc nước",690000,531000,77
174489164,Màng bọc thực phẩm Horeca Sunhouse KS-WR30250H,Sunhouse,112000,Việt Nam,Dụng cụ chứa đựng thực phẩm,173000,61000,35
246167977,"Cây chà sàn nhà tắm, chổi cọ sàn và gạt nước 2 trong 1, cọ sạch khe hẹp và góc tường – Parroti Easy ES04",Parroti,128250,Trung Quốc,Dụng cụ vệ sinh,135000,6750,5
274067035,Ổ cắm điện Philips CHP2452WB- 3m,Philips,240000,Trung Quốc,"Ổ cắm, ổn áp, biến áp",289000,49000,17
272306509,"Vòi Sen Tăng Áp, Đầu Vòi Hoa Sen Mát Xa 4 Trong 1, 3 Chế Độ Áp Suất Cao Tiết Kiệm Nước, Lõi Cotton Lọc Cho Nhà Tắm - HÀNG CHÍNH HÃNG MINIIN",MINIIN,83000,Trung Quốc,Thiết bị phòng tắm,99000,16000,16
272553066,"Túi Đựng Quần Áo Chăn Màn Vải Không Dệt Chống Thấm Nước Deli, Giỏ Đựng Quần áo Đa Năng Có Thể Gấp Gọn",Deli,35000,Trung Quốc,Phụ kiện giặt ủi,63000,28000,44
71206737,Đèn Pin Laser 303 - Hàng Chính Hãng,Essesa,126000,Trung Quốc,,135000,9000,7
217474961,"[KHÔNG CẦN DÙNG BƠM] Túi Hút Chân Không Đựng Quần Áo Chăn Ga Gối , Thú Bông Deli - Loại Dày Cao Cấp Bọc Để Chăn Màn 2 Lớp Khóa Zip Chống Rò Rỉ Hơi Bảo Vệ Quần Áo, Chăn Ga Khỏi Ẩm, Nấm Mốc, Chống Nước Tuyệt Đối",Deli,22000,Trung Quốc,Phụ kiện phòng ngủ,39600,17600,44
269846183,"Bộ Cây Lau Nhà Tự Vắt Thông Minh , Chổi Lau Nhà Xoay 360 Độ , Dễ Dàng Len Lỏi Làm Sạch Những Góc Khuất, Thùng Chứa Nước Thiết Kế 2 Ngăn Riêng Biệt Tích Hợp Lược Gỡ Rối Giúp Giặt Sạch Và Vắt Khô Bông Lau Nhanh Chóng Mà Không Cần Tiếp Xúc - DAMAS Magic G130",Damas,242250,Trung Quốc,Dụng cụ lau nhà,510000,267750,53
650498,Hũ Thủy Tinh Nắp Cài Kín Hơi Fido Bormioli Rocco 149230M04321991 (1500ml),Bormioli Rocco,179000,Ý,Dụng cụ chứa đựng thực phẩm,208000,29000,14
20671006,Kệ để đồ rửa bát có khay nhựa dán tường inox 304 Hobby Home Decor KRC1,Hobby Home Decor,179000,Trung Quốc,,179000,0,0
59259444,Mùng chụp tự bung cao cấp FUNU - Màn chống muỗi thông minh - Hàng chính hãng (Sản xuất tại Việt Nam),FuNu,132000,Việt Nam,Phụ kiện phòng ngủ,141050,9050,6
142795896,"Hộp đôn ghế ngồi Mai Anh House - ghế đôn đa năng vuông chất liệu vải Oxfort cao cấp, thân gỗ MDF cứng cáp, mặt nệm êm ái, nội thất thông minh ghế đôn xếp gọn phong cách Thụy Điển sang trọng, tinh tế",Mai Anh House,297200,Việt Nam,Nội thất phòng khách,297200,0,0
201572327,"Hộp vải đựng đồ chia ngăn HQ4 - Hộp đựng quần áo chia 9 ngăn, 16 ngăn gấp gọn chính hãng",miDoctor,85000,Việt Nam,Phụ kiện phòng ngủ,170000,85000,50
275465086,Khăn Tắm Quảng Phú Cotton BQX6 50x98cm,Mollis,80000,"Anh, Việt Nam",Khăn,80000,0,0
197615248,Thảm Chùi Chân 4 Lớp Siêu Thấm Hút - Họa Tiết Hoạt Hình - Chính Hãng NAVIVU,NAVIVU,99000,Trung Quốc,Phụ kiện nhà tắm,99000,0,0
191891544,Chảo nhôm chống dính Elmich Harmonia EL-3779,Elmich,216600,Việt Nam,Nồi và chảo,339000,122400,36
217575107,"Đèn pin siêu sáng KGT6 hợp kim chống nước, 1000 lumen, chiếu xa 200m tới 500m , pin sạc FullBox, tặng pin loại tốt- Hàng chính hãng",KINGO,115000,China / Vietnam,,165000,50000,30
51476716,"Bộ 10 đôi đũa inox 304 - 316 DandiHome 2020 chống trơn trượt, sang trọng, tinh tế",DandiHome,276000,Việt Nam,"Đũa, muỗng, nĩa",300000,24000,8
52316356,"Bộ máy khoan pin RAKUTEN 66V  khoan tường, khoan sắt, khoan bê tông máy 2 pin, đảo chiều và mũi khoan",rakuten,588000,,Các loại máy và phụ kiện,588000,0,0
52756206,1kg Túi Đựng Rác Tự Phân Hủy Sinh Học Gimex II (full size),Túi ni lông tự phân hủy sinh học GIMEX II,27000,Việt Nam,Dụng cụ vệ sinh,27000,0,0
135321411,"Giấy Bạc Tráng Nhôm, dán bếp tăng thẩm mỹ và rất sạch sẽ(2M)",OEM,32400,Việt Nam,Decal & giấy dán tường,32400,0,0
215891498,"Keo Acrylic B7000 / T7000 Dán Kính Điện Thoại, Dán Giày, Dán Nhựa, Kim Loại, Gỗ, Đá, Thủy Tinh, Da",NAVIVU,28500,Trung Quốc,Dụng cụ sửa chữa nhà cửa,28500,0,0
161225352,"Miếng dán đỡ kệ gỗ, chia ngăn tủ, không cần đóng đinh",OEM,12000,Trung Quốc,,12000,0,0
82877146,Đèn Bàn Học LED Chống Cận GHINER GN-1902 (Pin 4500mAh),GHINER,250000,China,Đèn học và đọc sách,320000,70000,22
134360700,"Vỉ 10 Viên Pin LR44 , Pin A76 , Pin AG13 1,5V Energizer - Hàng Chính Hãng",Energizer,52827,Trung Quốc,Pin và dụng cụ sạc pin,52827,0,0
85908084,Nhang Sạch Phòng Máy Lạnh - Ít khói - Hương trầm dịu nhẹ - Chân tăm mộc - Nhang Xanh - 300g - 20cm,Nhang Xanh,120000,Việt Nam,,120000,0,0
54682452,Pin vuông 9V Energizer 522 ALKALINE chính hãng ( Mẫu mới ),Energizer,65000,Singapore,Pin và dụng cụ sạc pin,65000,0,0
59495338,"Bình xịt chống thấm tường, chống dột đa năng Leak Sealer B125 Bosny - Nhập khẩu Thái Lan.",Bosny,159000,Thái Lan,"Sơn, dầu mỡ, hóa chất",159000,0,0
274317228,"Dây Cắm Điện Nối Dài Để Cắm Đèn, Quạt, Cục Sạc",NAVIVU,14500,Trung Quốc,"Ổ cắm, ổn áp, biến áp",14500,0,0
270211230,TÚI ĐỰNG RÁC MÀU 1KG 3 CUỘN TỰ HỦY,PEALO,52000,Việt Nam,Dụng cụ vệ sinh,85000,33000,39
275465029,Khăn Mặt Hải Cẩu Cotton FHD6 34x80cm,Mollis,38000,"Anh, Việt Nam",Khăn,38000,0,0
146384829,"Ghế xoay văn phòng công thái học ergonomic có ngả lưng Premium 02, ghế xoay Gaming cao cấp nhập khẩu",OEM,1262000,Đài Loan,"Nội thất phòng học, làm việc",2490000,1228000,49
131407951,Bàn làm việc bàn hoc chữ k,HG FURNITURE H i G,396000,Việt Nam,"Nội thất phòng học, làm việc",396000,0,0
191505971,Bình giữ nhiệt Lock&Lock Maman Cup Vacuum Bottle LHC1487GRY 505ml,LocknLock,256000,Trung Quốc,Bình/ Ly giữ nhiệt,515000,259000,50
274992707,Hộp Cơm 3 Tầng Lunch Box Kèm Muỗng Đũa Và Túi Đựng Tiện Lợi,PEAFLO,192000,Hàn Quốc / Trung Quốc,Dụng cụ chứa đựng thực phẩm,235000,43000,18
35905857,"Chảo Nhôm Sâu Lòng Chống Dính Baum Marble 1 Tay Cầm, Nắp Thủy Tinh Lock&Lock LBU1181 18cm",LocknLock,302000,Trung Quốc,Nồi và chảo,572000,270000,47
579850,Chảo Trơn Chống Dính Sunhouse CT26 26cm,Sunhouse,137000,Việt Nam,Nồi và chảo,210000,73000,35
273901995,"Ổ Cắm Điện Loại Chuyển Đổi Đa Năng - Phích Cắm Tiêu Chuẩn US, EURO, UK, AUST - Có 2 Cổng USB (Dual USB) - Phù Hợp Cho Những Chuyến Công Tác Và Du Lịch Nước Ngoài- Chính Hãng",PaKaSa,159460,Trung Quốc,,236000,76540,32
143363686,"Băng keo chống thấm x2000 Nhật Bản chống thấm dột, dán tường, dán mái tôn, dán ống nước",OEM,55000,Việt Nam,Dụng cụ sửa chữa nhà cửa,55000,0,0
192523772,"Tấm Lót Tủ Lạnh, Tủ Bếp, Tủ Quần Áo Nhựa EVA Dễ Dàng Vệ Sinh (Đủ màu, đủ size)",NAVIVU,46500,Trung Quốc,Phụ kiện nhà bếp,46500,0,0
10227148,Dụng Cụ Mài Dao 3 Lớp Lock&Lock CKK112 (245 x 53 x 72 mm),LocknLock,152000,Trung Quốc,"Dao, kéo và phụ kiện",275000,123000,45
25624037,Bật lửa mồi cồn và bếp gas,OEM,25000,,"Bếp nướng, vỉ nướng",25000,0,0
58252037,Bông Lau Nhà Microfiber Xoay 360 Độ Sunhouse KS-CO350M,Sunhouse,27100,Việt Nam,Dụng cụ lau nhà,35000,7900,23
68391419,ĐẦU VÒI RỬA CHÉN LỌC NƯỚC TĂNG ÁP 360 ĐỘ - giao màu ngẫu nhiên,OEM,19000,Trung Quốc,Phụ kiện nhà bếp,19000,0,0
270102591,"Nhiệt kế đo độ ẩm, máy đo nhiệt độ phòng cho bé - Nhiệt Ẩm Kế Điện Tử 3 Trong 1 - Thương hiệu RiBi - Hàng Chính Hãng",RIBI,150000,Trung Quốc,Thiết bị đo lường,165000,15000,9
206314531,"Đèn Học Để Bàn 2 Thanh 3 Chế Độ Sáng , Ánh Sáng Trắng Hoặc Vàng Tùy Chọn Giúp Bảo Vệ Mắt - Chính hãng",PaKaSa,161840,Trung Quốc,Đèn học và đọc sách,240000,78160,33
249682005,"Ruột Gối Hơi Nằm Thắng Lợi Size 50 x 70 x 10cm, 40x60x10cm, Gối ôm 35x100cm",Thắng Lợi,70000,Việt Nam,"Gối, ruột gối, vỏ gối",70000,0,0
115986994,Miếng Dán Tường Treo Ổ Cắm Điện Treo Wifi Móc Treo Đa Năng Tiện Lợi,OEM,9900,Trung Quốc,,9900,0,0
528939,Màng Bọc Thực Phẩm PVC Laspalms MBTP00006095 - 30cm x 300m,Laspalms,193000,Việt Nam,Phụ kiện nhà bếp,329175,136175,41
196932074,"Đèn bắt muỗi Điện Quang ĐQ EML08 BL - Diệt muỗi và côn trùng tự động theo 360 độ, công suất 6W, phạm vi hoạt động dưới 20m2",Điện Quang,281000,Việt Nam,,350900,69900,20
84886093,Vợt muỗi thông minh 3in1 SUNHOUSE SHE-PRO11.W,Sunhouse,213000,Trung Quốc,"Dụng cụ diệt chuột, côn trùng",344000,131000,38
57796007,Khăn tắm Lapyarn BM8V Mollis 60 x 120 cm,Mollis,169000,Việt Nam,Khăn,237000,68000,29
153579357,Rây Lọc Vớt Trần Thức Ăn Tiện Dụng - Hàng Nội Địa Nhật- Loại 1 - CHÍNH HÃNG MINIIN,MINIIN,37000,Nhật Bản / Việt Nam,Phụ kiện nhà bếp,43000,6000,14
273707598,Vỏ gối ôm Microfiber K-Bedding by Everon KMS 80x100 cm,K-Bedding,111150,Việt Nam,"Gối, ruột gối, vỏ gối",170000,58850,35
10407749,Chảo Chống Dính Smartcook SM2357217 (16cm),Smartcook,112000,,Nồi và chảo,239000,127000,53
185380271,"[Hàng Chính Hãng - BH 2 Năm]Keo Chống Thấm Trong Suốt TAIKOMI -Chống Thấm Gạch Lát Nền,Trần Vết Nứt Mái Nhà, Sàn Nhà Vệ Sinh Triệt Để",TAIKOMI,172000,Việt Nam,"Sơn, dầu mỡ, hóa chất",207000,35000,17
272547402,"Hộp vải đựng quần áo chia ngăn chống nước, Túi vải chia 12 ngăn đựng áo quần khung cứng sắp xếp tủ gọn gàng",Deli,29000,Trung Quốc,Nội thất phòng ngủ,52200,23200,44
275849675,"Bàn Chải Đánh Răng 3 Mặt, Bàn Chải Đánh Răng Đa Chiều Làm Sạch Đồng Thời Cả 3 Bề Mặt Của Răng, Lông Mềm Mượt",ASSTAR,88000,Trung Quốc,Phụ kiện nhà tắm,88000,0,0
54156958,Pin Sạc Energizer AAA 700mAh Power Plus,Energizer,160000,,Pin và dụng cụ sạc pin,160000,0,0
94724913,"Ron Dán Che Khe Cửa ,Chân Cửa,Khung Cửa CTFAST Chống Bụi, Ngăn Côn Trùng, Chống Ồn, Chống Thoát Nhiệt Điều Hòa, Chống Va Đập Cửa - Mẫu Cải Tiến 2021 ( Hàng Chính Hãng )",CTFAST,49000,Việt Nam,Bảo vệ nhà cửa,68000,19000,28
217778590,"Băng keo chống thấm KG13, chống dột dán siêu dính trên mọi bề mặt, dán mái tôn, tường, ống nước cao cấp dài 5m- Hàng chính hãng",KINGO,48000,Việt Nam,Dụng cụ sửa chữa nhà cửa,60000,12000,20
198800861,Ca nước giữ nhiệt LocknLock Metro Table Mug 600ml - LHC4282,LocknLock,279000,Trung Quốc,"Bình, ly uống cà phê và phụ kiện",529000,250000,47
134863256,Đầu Chuyển 3 Chấu Thành 2 Chấu Để Sử Dụng Các Loại Ổ Cắm Thông Dụng Ở Việt Nam - Chính Hãng,PaKaSa,25000,Trung Quốc,"Ổ cắm, ổn áp, biến áp",50000,25000,50
23199431,Nồi đất kho cá NodaCook Bát Tràng 2 lít (Đen),NodaCook,275000,Việt Nam,Nồi và chảo,380000,105000,28
20036138,5 Viên Pin CR2025 3V Panasonic Lithium made in Indonesia - Hàng chính hãng,Panasonic,80000,Thái Lan/ Indonesia/Trung Quốc,Pin và dụng cụ sạc pin,90000,10000,11
114204740,Bình giữ nhiệt inox 304 Sunhouse 900ml KS-TU900I,Sunhouse,139000,Việt Nam,Bình/ Ly giữ nhiệt,225000,86000,38
189182484,"Hộp đựng đồ đa năng CA01 – Túi vải đựng quần áo chăn màn phong cách Châu Âu sang trọng, lịch sự D Danido",D Danido,84000,Việt Nam,Nội thất phòng ngủ,119000,35000,29
198219660,"Bộ chuyển đổi ổ cắm 3 chấu thành 2 chấu, phích cắm chuyển đổi 3 chấu tiêu chuẩn US, EURO, UK, AUST phù hợp với hầu hết các tiêu chuẩn ổ cắm của các quốc gia - Hàng chính hãng, giao màu ngẫu nhiên",BARWELL,22000,Trung Quốc,"Ổ cắm, ổn áp, biến áp",22000,0,0
275465813,Khăn Mặt Khăn Gội Đầu Hải Cẩu Cotton 34x78cm FHN3,Mollis,38000,"Anh, Việt Nam",Khăn,38000,0,0
275465112,Khăn Mặt Belleto FQAC 40x78cm,Mollis,85000,Việt Nam,Khăn,85000,0,0
274570946,"Ga Giường, Drap Nệm Thun Lạnh Cariva Đủ Kích Thước",Cariva,85000,Việt Nam,,85000,0,0
115092053,"Bộ ga giường poly cotton LIDACO drap giường đủ size nệm 1m2, 1m4, 1m6, 1m8",LIDACO,66000,Việt Nam,,100000,34000,34
696495,Ổ Cắm Điện 4 Lỗ 3 Chấu 3m Philips SPN1348WB/74 (2500W),Philips,321000,Trung Quốc,"Ổ cắm, ổn áp, biến áp",369000,48000,13
272421704,Giàn Phơi Quần Áo Kéo Dài Gấp Gọn Thông Minh VANDO Kèm Bánh Xe Di Chuyển Linh Hoạt,VANDO,499000,Trung Quốc,Phụ kiện giặt ủi,499000,0,0
275376339,Giá Treo Quần Áo Thời Trang Cao Cấp 2 Khung 2 Tầng Kèm Móc Treo Tiện Lợi,Anh Lam Store,325000,Việt Nam,Phụ kiện giặt ủi,450000,125000,28
273712175,"Kẹp Dán Tường Đi Dây Điện, Dây Cáp Gọn Gàng Loại Cao Cấp",NAVIVU,25000,Trung Quốc,,25000,0,0
20103667,Combo Cọ Rửa Dành Cho Ống Hút Inox và Ống Hút Thủy Tinh,OEM,16500,,"Ly, cốc & phụ kiện ly",16500,0,0
53497035,40 VIÊN PIN MAXELL AAA TEM BẠC - HÀNG CHÍNH HÃNG,Maxell,59000,,Pin và dụng cụ sạc pin,59000,0,0
27609461,"Dụng cụ thông tắc bồn cầu, cống bằng khi nén áp lực siêu mạnh",OEM,239000,HK/TQ,Dụng cụ vệ sinh,290000,51000,18
31323175,"CHỔI LAU NHÀ TỰ VẮT THÔNG MINH CAO CẤP, 2 BÔNG LAU, MÂM LAU HÌNH CHỮ NHẬT, LAU CỰC SẠCH",VY LONG,172000,Trung Quốc / Singapore / Việt Nam,Dụng cụ lau nhà,176999,4999,3
271907736,Bộ dao 6 món nhà bếp Nhật Bản siêu sắc bén cao cấp - Logo trên thân dao ngẫu nhiên - Chính hãng,miDoctor,182000,China / Vietnam,"Dao, kéo và phụ kiện",188000,6000,3
2127549,Bình Đựng Dầu Với Nắp Mở Tự Động Lock&Lock CKO101BLK (550ml),LocknLock,125000,Trung Quốc,Dụng cụ chứa đựng thực phẩm,241000,116000,48
186862075,"Nắp Ngăn Mùi Thoát Sàn ECODEALS - Chặn Mùi Hôi Cống, Chống côn trùng, Chống trào ngược - MẪU MỚI CẢI TIẾN, ĐỦ KÍCH CỠ",ECO deals,23000,Việt Nam / Đài Loan,Thiết bị phòng tắm,23000,0,0
257770303,Ly nhựa 2 lớp LocknLock HAP507VOLH Rainbow - kèm ống hút 750ml - Màu cầu vồng,LocknLock,108000,Trung Quốc,"Bình, ly uống trà và phụ kiện",217000,109000,50
62469165,Ga Chống Thấm Cotton LIDACO Cao Cấp,LIDACO,164000,Việt Nam,,164000,0,0
56737206,Túi Rác Tự Hủy Có Quai Tiện Dụng SOJI INOCHI Nhật Bản - Màu Đen Dạng Cuộn - Nhiều Size - Đa dạng công năng sử dụng,Inochi,20000,Việt Nam,Dụng cụ vệ sinh,20000,0,0
66463147,Màn tự bung FuNu chống muỗi an toàn - Hàng Chính Hãng ,FuNu,215000,Việt Nam,Phụ kiện phòng ngủ,230000,15000,7
217577658,"Đầu nối vòi nước KG17 tăng áp thông minh chứa hạt lọc bẩn, phù hợp mọi loại vòi xoay 360độ khoảng 3.5cm (giao màu ngẫu nhiên)",KINGO,28000,China,Phụ kiện nhà bếp,45000,17000,38
273901280,Cuộn Túi Hút Chân Không Thực Phẩm Một Mặt Nhám Một Mặt Trơn Dạng Hạt Mịn Phù Hợp Cho Tất Cả Các Dòng Máy Hút Chân Không - Hàng Chính Hãng,PaKaSa,59000,Trung Quốc,Dụng cụ chứa đựng thực phẩm,118000,59000,50
156165766,Ổ Cắm Du Lịch Đa Năng Thông Minh Phích Cắm Chuyển Đổi Bugu HHT931 - Hàng Chính Hãng,Bugu,125800,Trung Quốc,"Ổ cắm, ổn áp, biến áp",148000,22200,15
191918107,Bình lắc LocknLock Balance Shake It Bottle HAP949BLK 800ml - Màu,LocknLock,139000,Trung Quốc,,267000,128000,48
173632127,Áo Mưa Bít Vải Dù,PEAFLO,106000,Trung Quốc / Singapore / Việt Nam,"Áo mưa, ô dù và phụ kiện đi mưa",125000,19000,15
73147684,"Thanh xốp gắn chân cửa chống kẹt chân cho bé, bịt khe hở, chắn gió, chặn côn trùng",OEM,40000,Trung Quốc,Bảo vệ nhà cửa,40000,0,0
70825693,Pin Cr2025 Energizer 3V vỉ 1 viên,Energizer,32800,Indonesia,Pin và dụng cụ sạc pin,32800,0,0
275465069,Khăn Mặt Hải Cẩu Cotton FHC1 34x82cm,Mollis,33000,"Anh, Việt Nam",Khăn,33000,0,0
270770782,Keo đa năng dán gỗ đá hoa cương gạch men sứ tường cầu thang sàn chống nước chịu nhiệt chịu tải lực Legaxi,Legaxi,33000,Trung Quốc,Dụng cụ sửa chữa nhà cửa,33000,0,0
271887126,Kệ để điện thoại,HUCHU,980,"Anh, Việt Nam","Nội thất phòng học, làm việc",1000,20,2
25421013,"Bộ Nồi Inox 3 Đáy Sunhouse SH335(16cm, 20cm, 24cm ) - Dùng trên mọi loại bếp - Hàng chính hãng",Sunhouse,380160,Việt Nam,Nồi và chảo,620000,239840,39
271288543,"Ghế Xoay Văn Phòng TANNI Premium 01, Ghế Làm Việc Công Thái Học Cao Cấp",TANNI,755000,Đài Loan,"Nội thất phòng học, làm việc",1650000,895000,54
15605817,Bộ Dao Nhà Bếp 5 Món Cookplus Lock&Lock CKK101S5BLK,LocknLock,161000,Trung Quốc,"Dao, kéo và phụ kiện",292000,131000,45
75659112,Kệ Sách Tổ Ong IGEA Đa Tầng Convent 234F - GP100,IGA,135000,Việt Nam,"Nội thất phòng học, làm việc",135000,0,0
88928025,Ổ Cắm Điện Đa Năng Kèm Cổng USB Có Công Tắc Tải 2500W Nắp Chống Giật Chống Cháy Chất Lượng Cao Deli - Dây 2M/3M/5M - ET401 411,Deli,135000,Trung Quốc,"Ổ cắm, ổn áp, biến áp",243000,108000,44
69193092,Bộ đầu nối vòi rửa chén tăng áp 3 chế độ Hobby Home Decor VSTADAY có khớp nối,Hobby Home Decor,82000,Trung Quốc,Phụ kiện nhà bếp,129000,47000,36
199105290,"Set 10 Đèn LED Bi Mini Trang Trí Bong Bóng, Đồ Chơi, Quà Tặng Sáng Tạo",NAVIVU,57000,Trung Quốc,,57000,0,0
71924330,Bộ Chổi Quét Nhà Lock&Lock Gồm Cây Chổi và Dụng Cụ Hốt ETM465,LocknLock,236000,Trung Quốc,Dụng cụ lau nhà,428000,192000,45
1400785,Gối Memory Foam 50D Hình Dáng Thường Lock&Lock HLW112 (50 x 30 cm) - Trắng,LocknLock,242000,Trung Quốc,"Gối, ruột gối, vỏ gối",439000,197000,45
95895598,Ổ khóa treo Việt Tiệp hợp kim chống cắt trắng,Việt Tiệp,174200,Việt Nam,Bảo vệ nhà cửa,174200,0,0
275381161,"Bộ tua vít đa năng dùng sửa chữa điện thoại, đồng hồ đeo tay máy tính laptop, đồ điện tử",ratoff-ars,55000,China,Các loại máy và phụ kiện,55000,0,0
273935273,Keo Nước Hữu Cơ Siêu Dính Gấp 2000 Lần,NAVIVU,49100,Thái Lan / Trung Quốc,Dụng cụ sửa chữa nhà cửa,49100,0,0
275362379,Bộ Đầu vòi xịt vệ sinh (toilet) inox SUS 304,ratoff-ars,72000,China,Thiết bị phòng tắm,72000,0,0
204083681,"Đĩa Giấy Nến Thấm Dầu Lót Nồi Chiên Không Dầu, Chịu Nhiệt, Không Dính, Hút Dầu Mỡ",NAVIVU,15000,Việt Nam,Phụ kiện nhà bếp,15000,0,0
247395139,"Đinh 4 Chân Đóng Tường Không Cần Khoan Treo Tranh, Giá Đỡ Khung Tranh",NAVIVU,15000,Trung Quốc,,15000,0,0
275889802,"Cây lau kính, bàn bếp KG5S đa năng tự vắt thông minh, bọt biển siêu thấm hút gập gọn mini 25cm - Hàng chính hãng",KINGO,44000,China,Phụ kiện nhà bếp,65000,21000,32
15432583,Kệ để bàn chải kem đánh răng dán tường inox 304 Hobby home decor KBC31,Hobby Home Decor,84000,Trung Quốc,,135000,51000,38
198069246,"Bộ cây lau nhà VinBuy kèm thùng tự vắt thông minh, chổi lau nhà xoay 360 độ lau sạch nhanh",VinBuy,238000,China / Vietnam,Dụng cụ lau nhà,500000,262000,52
206706648,"Bài Chải Chà Nhà Tắm , Bàn Chải Chà Sàn Hai Mặt 3 Trong 1 ,Bàn Chải Lông Cứng Có Tay Cầm Ống Lồng GroFa",Gro-Fa,74000,Trung Quốc,Dụng cụ vệ sinh,74000,0,0
6137123,"Phân Bón Npk 20-20-15 đa năng 3 màu  (1Kg)- bón cây, rau, cây ăn trái, hoa kiểng - bón gốc dễ sử dụng, kích thích ra lá, ra hoa, đậu trái",Bình Điền Mekong,45000,Việt Nam,"Hoa tươi, Cây cảnh & Hạt giống",45000,0,0
138465363,Bộ chuyển đổi máy khoan thành cưa lọng đa năng kèm theo 3 lưỡi,OEM,99000,Việt Nam,Các loại máy và phụ kiện,99000,0,0
135442444,"Kìm Cắt Dây Điện Đa Năng Deli Cao Cấp Chính Hãng - Kích Thước 6 Inch - Lưỡi Thép Sắc Bén, Tay Cầm Chống Trượt - EDL2706",Deli,87000,Việt Nam,Dụng cụ sửa chữa nhà cửa,156600,69600,44
190512159,Nước Ngâm Rửa Rau Củ Quả Sinh Học ENZYCO Lên Men Từ Dứa Loại Bỏ Hóa Chất Khử Mùi Tanh Thịt Cá - 1 Lít,ENZYCO,89000,Việt Nam,Phụ kiện nhà bếp,95000,6000,6
272135610,Combo 5 Móc Treo Quần Áo Trong Suốt PaKaSa - Hàng Chính Hãng,PaKaSa,79000,Trung Quốc,Phụ kiện giặt ủi,138000,59000,43
275723393,AS - ÁO MƯA CÁNH DƠI,FWD,59000,Việt Nam,"Áo mưa, ô dù và phụ kiện đi mưa",59000,0,0
274470797,Bình giữ nhiệt Slo 2in1 with tumbler LocknLock LHC4332 (Bình giữ nhiệt và cốc nhựa) 600ml,LocknLock,334000,Trung Quốc,Bình/ Ly giữ nhiệt,630000,296000,47
273953066,"Bàn làm việc kết hợp với giá sách thiết kế rất trẻ trung và hiện đại, Bàn học kèm kệ mặt gỗ MDF phủ melamine cao cấp",Nội Thất 5C,589000,Việt Nam,"Nội thất phòng học, làm việc",799000,210000,26
14251502,Lưới Võng Đại Tín Thành Phát,Tín Thành Phát,279000,Việt Nam,Phụ kiện phòng ngủ,300000,21000,7
273935253,"Đèn Ngủ Cảm Biến Ánh Sáng Tự Bật Ban Đêm, Ánh Sáng Dịu, Tiết Kiệm Điện",NAVIVU,18000,Trung Quốc,Đèn ngủ,18000,0,0
275051507,Đèn đường năng lượng mặt trời 300w,Vạn Năng Solar,849000,Trung Quốc,Đèn ngoài trời,999000,150000,15
181410158,Bàn Làm Việc Đa Năng Decor Phong Cách Gaming Thương Hiệu IGA - GM62,IGA,320000,Việt Nam,"Nội thất phòng học, làm việc",320000,0,0
73829087,Kệ để đồ rửa chén bát gác trên bồn rửa inox 304 Hobby Home Decor KRC5,Hobby Home Decor,99000,Trung Quốc,,159000,60000,38
56383693,Combo 300 túi lọc rác bồn rửa bát,OEM,75000,Trung Quốc,Phụ kiện nhà bếp,95000,20000,21
262729683,"Giá Treo Quần Áo Kim Loại Không Gỉ Kệ Quần Áo Nhiều Kích Cỡ Deli Tiện Lợi, Đơn Giản Chắc Chắn Có Thể Tự Lắp, Giàn Phơi",Deli,199000,Trung Quốc,Phụ kiện giặt ủi,358200,159200,44
198510237,"Chậu Trồng Cây Greenhome, Nhựa Nguyên Sinh Lắp Ráp, Nhiều Kích Thước, Trồng Hoa Hồng, Rau, Củ, Quả, Độ Bền 5 Năm",Greenhome,149000,Việt Nam,"Hoa tươi, Cây cảnh & Hạt giống",240000,91000,38
199638326,Tựa Lưng Ghế Văn Phòng Công Thái Học Đệm Tựa Lưng Văn Phòng,Office Chill,435000,Việt Nam,"Nội thất phòng học, làm việc",492000,57000,12
100522012,"Cây Lau Nhà Thông Minh, Chổi Lau Nhà 360 Độ Đa Năng (Không Bao Gồm Thùng Vắt) - Parroti MOP-PR01",Parroti,196650,Trung Quốc,Dụng cụ lau nhà,207000,10350,5
272484433,Đồng hồ treo tường kim trôi không ồn minimalist phong cách tối giản trang trí phòng khách Bảo hành 12 tháng Deli,Deli,159000,Trung Quốc,Đồng hồ,286200,127200,44
205856283,"Bộ ga giường K-Bedding KMP chất liệu Microfiber bền chắc, kháng khuẩn (KHÔNG BAO GỒM CHĂN)",K-Bedding,405000,Việt Nam,,650000,245000,38
205894449,"Móc dán tường siêu dính, móc dán tường decor - Hàng chính hãng",FuNu,14250,Trung Quốc,,15000,750,5
271046616,Ly Giữ Nhiệt Inox 304 600ml Độ Bền Cao Tặng Kèm Ống Hút Inox Và Túi Đựng Ly Trong Suốt - Chính Hãng,lilahome,75000,Trung Quốc,Bình/ Ly giữ nhiệt,150000,75000,50
20580153,Võng xếp khung thép cao cấp VINANOI KVT32 - Lưới võng cỡ đại màu xanh lá,VINANOI,480000,Việt Nam,Phụ kiện phòng ngủ,780000,300000,38
135041265,Bộ Tua Vít Đa Năng 32 Đầu - PaKaSa ( Màu ngẫu nhiên),PaKaSa,49000,Trung Quốc,,98000,49000,50
74014046,Bộ 6 Ống Hút Silicone Có Thể Tái Sử Dụng Kèm 2 Cọ Rửa Lock&Lock TLL080 ( 250 x 78 mm),LocknLock,75900,Trung Quốc,"Ly, cốc & phụ kiện ly",138000,62100,45
135442343,"Hộp Đựng Đồ Nghề, Dụng Cụ Đa Năng Deli Cao Cấp Chính Hãng 14/17/19'' Chất Liệu Chắc Chắn DL-TC240 / DL-TC270 / DL-TC290",Deli,430200,Trung Quốc,,430200,0,0
164479566,"Ghế chỉnh dáng ngồi đúng - Roichen Hàn Quốc (Made in Korea). Dùng cho Nam, Nữ, Trẻ em. Hàng chính hãng",Roichen,660000,Hàn Quốc,Nội thất phòng ngủ,750000,90000,12
275480953,Ổ Cắm Điện Nối Dài Có Cổng USB Giá Rẻ,NAVIVU,75000,Trung Quốc,"Ổ cắm, ổn áp, biến áp",75000,0,0
273938776,Bình pha trà cà phê Cold Brew Hario MCPN 600ml / 1L,Hario,388000,Nhật Bản,"Bình, ly uống cà phê và phụ kiện",498000,110000,22
103564402,Dây vòi hoa sen vòi xịt inox 304 chịu áp lực cao Hobby home decor DS,Hobby Home Decor,65000,Trung Quốc,Thiết bị phòng tắm,65000,0,0
263210087,"Bộ 2 bóng đèn LED Bulb PHILIPS Essential E27 - Tiết kiệm điện, Ánh sáng chất lượng cao - Hàng Chính Hãng",Philips,65000,Trung Quốc,Bóng và linh kiện đèn,93000,28000,30
271739205,"Áo mưa trẻ EM CHO BÉ TRAI BÉ GÁI CÓ CHIỀU CAO TỪ 80CM-140CM , CHẤT LIỆU eva MỀM MẠI AN TOÀN , CHỐNG THẤM , SIÊU BỀN - BORO SPORT",CLEACCO,129000,Trung Quốc,"Áo mưa, ô dù và phụ kiện đi mưa",199000,70000,35
209331072,Đồng Hồ Để Bàn Báo Thức GHM hẹn giờ sang trọng kim trôi không gây tiếng động chuông to hiện đại cao cấp cho phòng ngủ,Shouse,168000,Trung Quốc / Singapore / Việt Nam,Đồng hồ,168000,0,0
274758261,Combo 10 Móc treo đồ hình chữ S chịu lực Chất liệu inox không gỉ Siêu cứng Chịu lực Chắc chắn Nhiều kích thước Sx tại VN,Fresh Friend,20000,Việt Nam,,20000,0,0
165767116,"Thước Kẻ Thép Deli Cao Cấp - Kích Thước 15cm Nhỏ Gọn, Tiện Lợi - Chất Liệu Chống Mòn Gỉ - DL8015",Deli,8000,Trung Quốc,Thiết bị đo lường,14400,6400,44
126733950,"Hộp trữ đông, bảo quản thực phẩm Freezermate Fit in Pack nhựa nguyên sinh an toàn hàng Made in Japan",Sanada Seiko,38500,Nhật Bản,Dụng cụ chứa đựng thực phẩm,38500,0,0
252178835," Móc dán tường pha lê 6 móc trong suốt, thanh treo đồ dán tường siêu dính giúp tiết kiệm không gian, decor nhà cửa tiện lợi- Hàng chính hãng ",FuNu,27000,Trung Quốc,,29000,2000,7
247820808,"Đèn bàn đèn học cảm ứng bảo vệ thị lực RD-RL-45 phong cách sáng tạo, tiện lợi với ống đựng bút, đổi được màu ánh sáng và tăng giảm cường độ sáng, chính hãng Rạng Đông",Rạng Đông,325000,Việt Nam,Đèn học và đọc sách,325000,0,0
275009897,Giấy Rút Treo Tường Tiện Lợi 4 Lớp Cao Cấp - hàng chính hãng,Nhà của Mẹ,45000,China / Vietnam,Phụ kiện phòng ăn,45000,0,0
275570183,Bình đựng thức ăn giữ nhiệt inox 304 Elmich EL8336 dung tích 800ml,Elmich,314450,Trung Quốc,Bình/ Ly giữ nhiệt,750000,435550,58
173211404,"Ghế Xoay Văn Phòng Ngồi Làm Việc Công Thái Học Deli - Tay Gập Thông Minh, Có Ngả Lưng, Lưới Thoáng Khí, Chân Xoay Tiện Ích, Đệm Ghế Êm Aí - Phù Hợp Học Sinh, Văn Phòng, Game Thủ, Gaming - Hàng Chính Hãng",Deli,1199000,Trung Quốc,"Nội thất phòng học, làm việc",1528200,329200,22
13561921,Bộ 2 Thớt Gỗ Cây Cao Su Lock&Lock LWC001S2,LocknLock,211000,Việt Nam,Phụ kiện nhà bếp,405000,194000,48
10646782,Hộp 12 viên diệt gián của Nhật Bản,OEM,28000,,"Dụng cụ diệt chuột, côn trùng",90000,62000,69
53647975,"1 Gối Ôm thương hiệu A có khóa kéo - an toàn sức khỏe, không chứa chất độc hại - êm ái, mềm mịn - KT",A,120000,Việt Nam,"Gối, ruột gối, vỏ gối",150000,30000,20
275287501,VỈ 20C KEO 3M MỚI Nẹp Cố Định Dây Điện Kẹp Giữ Cáp Sạc Nẹp Dây Điện Chống Rối Dán Tường,GUANG MING,25000,Trung Quốc,,39000,14000,36
93095439,NỆM CAO SU NON MASSAGE THẮNG LỢI HÀNG CHÍNH HÃNG BẢO HÀNH 15 NĂM VỀ SỤT LÚN,Nệm Thắng Lợi,1100000,Việt Nam,Nệm và phụ kiện,1100000,0,0
217148812,Đèn Bàn Học LED RG0 Tamayoko 3 Chế Độ Ánh Sáng Bảo Vệ Mắt Chống Cận Thị Không Phát Xạ Ánh Sáng Xanh Model TB-55S/SW,Tamayoko,824000,Trung Quốc,Đèn học và đọc sách,1100000,276000,25
275307345,"Đèn Học Led Bảo Vệ Mắt Tích Điện, Đèn Led Cảm Ứng 3 Chế Độ Sáng Cao Cấp, Gắn Phòng Ngủ Có Đế Để Bàn Và Dính Tường",fofaHome,54000,Trung Quốc,Đèn học và đọc sách,99000,45000,45
176592358,Cây lau nhà tự vắt đa năng Sunhouse KS-MO3211PW,Sunhouse,139000,Việt Nam,Dụng cụ lau nhà,263000,124000,47
275407662,"Ổ Cắm Điện Kèm Cổng USB Công Tắc Riêng Chịu Tải 2500W, Chống Giật, Chống Cháy",NAVIVU,178000,Trung Quốc,"Ổ cắm, ổn áp, biến áp",178000,0,0
191326389,Pin sạc AA/AAA Beston chính hãng 1.5V kèm bộ sạc nhanh tự ngắt hàng cao cấp,BESTON,119000,Trung Quốc,Pin và dụng cụ sạc pin,119000,0,0
206548283,Bình Đựng Nước Chịu Nhiệt Độ Cao SOIKA 1.7L Và 2.7L SW01,Soika,161000,Trung Quốc,,196000,35000,18
101921036,"Bóng đèn PHILIPS LEDBULB Mycare A60 -Công suất (4W,6W,8W,10W,12W)",Philips,48200,Trung Quốc,Bóng và linh kiện đèn,92000,43800,48
217575063,"Miếng xốp KG18 bọc chân cửa chắn gió chống bụi, ngăn tiếng ồn, côn trùng cách âm chống kẹt chân kt 93X9.6cm - Hàng chính hãng",KINGO,28000,Việt Nam,Dụng cụ sửa chữa nhà cửa,55000,27000,49
247918899,Phích Cắm Chuyển 3 Chấu Thành 2 Chấu Dẹp,NAVIVU,30000,Trung Quốc,"Ổ cắm, ổn áp, biến áp",30000,0,0
34816875,"Dụng Cụ Thông Tắc Cống, Kẹp Gắp Rác Đa Năng Loại Tốt",OEM,34000,,Dụng cụ vệ sinh,36500,2500,7
69929041,"Móc Treo Quần Áo, Móc Phơi Đồ Trẻ Em Inox Kẹp Chống Rơi, Móc Treo Tất, Vớ, Đồ Lót Nhiều Kiểu Dáng",OEM,50000,Việt Nam,Phụ kiện giặt ủi,50000,0,0
52484490,Keo Dán Chống Thấm Siêu Dính Nhật Bản Bosui Dài 5m ,OEM,39000,Trung Quốc,Dụng cụ sửa chữa nhà cửa,55000,16000,29
221011957,"Ô Dù Gấp Gọn Mini Teement 19cm, Dù Che Mưa, Dù Chống Tia Uv Mini Siêu Gọn 8 Xương, Có Hộp Đựng Chống Sốc - Hàng Chính Hãng",TEEMENT,180000,Trung Quốc,"Áo mưa, ô dù và phụ kiện đi mưa",180000,0,0
54132706,"Bộ sạc Energizer Charger kèm 4 pin Ener AA 2000mAh, tự ngắt sạc (CHVCM4) ( Mẫu mới)",Energizer,446000,,Pin và dụng cụ sạc pin,460000,14000,3
271075110,"Cây Lăn Bụi Làm Sạch Quần Áo, Ga Giường, Sofa, Lông Chó Mèo 16cm GD726-Lanbui16",So Easy,22000,Trung Quốc,Phụ kiện giặt ủi,22000,0,0
52761048,"Chảo Gang Tròn Làm Bánh Mì Chảo , Bò Beefsteak , Cơm Xèo Đa Năng Size 20cm (Có Kèm Đế Lót Gỗ Tiện Lợi)",Dragon,155000,Việt Nam,Nồi và chảo,155000,0,0
271079058,Bình nước thể thao Lafonte 700ml - 003322 - BLA,La Fonte,82000,Trung Quốc,,161000,79000,49
272639422,Tách Capuccino Sứ Trắng OHIO,OHIO,29000,Việt Nam,,29000,0,0
14384384,"Chế phẩm sinh học hữu cơ vi sinh Trichoderma 1000g (chứa nấm đối kháng Trichoderma,Bacillus subtilis,Streptomyces spp) - Trichoderma fungi 1000g",ĐT02,69000,,"Hoa tươi, Cây cảnh & Hạt giống",69000,0,0
32021496,Ổ Khóa Số Du Lịch Stanley S742-056,Stanley,146000,Trung Quốc,Bảo vệ nhà cửa,167000,21000,13
275353932,"Tay vịn nhà tắm KG93 an toàn chống trơn trượt cho người lớn tuổi, người khuyết tật inox304 - Hàng chính hãng",KINGO,150000,Việt Nam,Thiết bị phòng tắm,190000,40000,21
274113380,"Dinh Dưỡng Thủy Canh HydroUmat V - Cho Cây Ăn Trái (Cà chua, Dưa Leo, Su Hào...)",HydroLand,75000,Việt Nam,"Hoa tươi, Cây cảnh & Hạt giống",75000,0,0
98165099,Bình đựng dầu gội sữa tắm nước rửa tay khách sạn bằng sứ đẹp màu đen trắng  - 300ml,Đức Ngọc Ceramic,120000,Việt Nam,Phụ kiện nhà tắm,120000,0,0
275465099,Khăn Mặt Quảng Phú FQW8 34x74cm,Mollis,42000,"Anh, Việt Nam",Khăn,42000,0,0
183370348,BỌC 50 ĐINH RIVE TOLSEN SIZE TỪ (2.4x6.4mm-4.8x16mm) - HÀNG CHÍNH HÃNG,Tolsen,15820,China,Dụng cụ sửa chữa nhà cửa,15820,0,0
273447279,"Dụng cụ châm bì, xăm bì, xâm bì, cây châm thịt, xâm thịt, xăm thịt, làm mềm thịt, làm heo quay da giòn (Xăm Thịt) GD29-DTB",So Easy,29000,Việt Nam,Phụ kiện nhà bếp,29000,0,0
198198085,"Dụng Cụ Nhấc Nắp Bồn Cầu Thông Minh ECODEALS - Nhỏ gọn, tiện dụng, chống vi khuẩn đôi tay",ECODEALS,28000,Đài Loan,Dụng cụ lau nhà,35000,7000,20
273787401,"Nước tắm tượng phật, lau bàn thờ tinh dầu quế Peace Mass 250ml phong thủy",PEACE MASS,33840,Việt Nam,Vật phẩm phong thủy,36000,2160,6
104270135,Bình Giữ Nhiệt LocknLock Featherlight One-touch Tumbler 500ml LHC3257WHT - Màu trắng,LocknLock,256000,Trung Quốc,Bình/ Ly giữ nhiệt,517000,261000,50
190791221,"Hộp 4 pin sạc AA AAA Beston dung lượng cao, sạc lại nhiều lần - Hàng chính hãng",BESTON,60000,Trung Quốc,Pin và dụng cụ sạc pin,60000,0,0
190989483,Bình giữ nhiệt Baby Inox 316 Elmich EL8017 dung tích 300ml,Elmich,247000,Trung Quốc,Bình/ Ly giữ nhiệt,319000,72000,23
74307763,Chảo Wok Lock&Lock Handycook LHD1165 Có Tay Cầm 15.5cm - Màu Xám,LocknLock,134000,Việt Nam,Nồi và chảo,242000,108000,45
101870479,"Thanh treo rèm cửa đa năng, không cần khoan tường hay bắt vít, thay đổi vị trí linh hoạt",PEAFLO,60000,Việt Nam / Trung Quốc,Nội thất phòng khách,85000,25000,29
145762384,"Khăn tắm lớn cotton cao cấp 70x140cm chuẩn khách sạn 5 sao thấm hút tốt, bông tự nhiên mềm mại Homemark Towel Collection",Hanvico,207000,Việt Nam,Khăn,282000,75000,27
275508158,"Khăn Tắm Nén Du Lịch 70x140cm Dạng Viên Nén Làm Từ Cotton Tự Nhiên, Sử Dụng Nhiều Lần",NAVIVU,32000,Trung Quốc,Khăn,32000,0,0
273509069,Chổi chà sàn nhà tắm thông minh 2in1 tích hợp cây gạt nước sàn nhà vệ sinh và lau kính - Chổi lau sàn đa năng,PEAFLO,45000,HK/TQ,Dụng cụ lau nhà,59000,14000,24
263451821,Bình Nước Thủy Tinh Chịu Nhiệt Độ Cao Từ -20o C Đến 130o C Soika SC05,Soika,93000,Trung Quốc,,123000,30000,24
272639442,Hộp bảo quản thủy tinh LocknLock BLANC - Hộp vuông,LocknLock,55600,Trung Quốc,Dụng cụ chứa đựng thực phẩm,101000,45400,45
25412653,Cây lăn bụi quần áo đa năng kèm 2 cục dự phòng,OEM,36000,,Phụ kiện giặt ủi,36000,0,0
54133235,Pin Sạc AA 2000mAh NH15 Power Plus RP2 Energizer NH15 RP2 (Mẫu mới),Energizer,160000,,Pin và dụng cụ sạc pin,160000,0,0
262783371,"Túi trong suốt đựng bình, ly giữ nhiệt - Chính hãng",FuNu,19000,Trung Quốc,Bình/ Ly giữ nhiệt,20000,1000,5
517873,Giá Phơi Đồ Inox Co Giãn Thông Minh Prota - 86 Cm,Prota,256500,Việt Nam,Phụ kiện giặt ủi,285000,28500,10
13561925,Nồi Hấp 2 Tầng Bằng Inox Lock&Lock LLH1282 (28cm),LocknLock,706000,Trung Quốc,Nồi và chảo,1319000,613000,46
173636676,Áo Mưa vải Dù PEAFLO - Áo Mưa Cánh Dơi 2 Đầu - Màu Ngẫu Nhiên,PEAFLO,129000,"Việt Nam / Hàn Quốc / Ấn Độ / Trung Quốc,...","Áo mưa, ô dù và phụ kiện đi mưa",165000,36000,22
152521474,Combo 200 Túi Lọc Rác Bồn Rửa Bát - Túi Lưới Lọc Rác Giúp Ngăn Chặn Tắc Đường Ống- Hàng Loại 1 - Chính Hãng MINIIN,MINIIN,26000,Trung Quốc,Dụng cụ vệ sinh,32000,6000,19
263274550,"Chậu trồng cây tự tưới thông minh MONROVIA, cho hoa, cây cảnh, bonsai, để bàn, ban công Tiêu Chuẩn Châu Âu",Monrovia,25000,Việt Nam / Trung Quốc,"Hoa tươi, Cây cảnh & Hạt giống",25000,0,0
72008054,Nồi hấp inox 2 tầng tiện lợi tặng kèm khăn lau bếp,HBH,86000,Trung Quốc,Nồi và chảo,86000,0,0
191587220,"Đệm ngồi bệt vuông, đệm lót ghế văn phòng vải nhung cao cấp A - 40x40x6cm giao màu ngẫu nhiên",A,65000,Việt Nam,Nội thất phòng khách,99000,34000,34
201112268,"Thảm Nhà Bếp Siêu Thấm Dễ Dàng Vệ Sinh, Thảm Silicon 4 Lớp NAVIVU",NAVIVU,116620,Trung Quốc,Phụ kiện nhà bếp,116620,0,0
73371758,"Găng tay làm vườn -  Găng Tay Chống Cắt Ansell 11-801 Cấp Độ 1 - Chống Đâm Xuyên, Giặt Và Tái Sử Dụng",Ansell,60000,Sri LanKa,Dụng cụ làm vườn,60000,0,0
71924152,"Mùng chụp, màn chụp tự bung chống muỗi FUNU - Hàng chính hãng, sản xuất tại Việt Nam",FuNu,114950,Việt Nam,Phụ kiện phòng ngủ,121000,6050,5
548911,Combo 4 Chai Thủy Tinh Quattro Bormioli Rocco QS19 - 400ml,Bormioli Rocco,347000,Ý,,403000,56000,14
216476965,Bộ quần áo mưa 2 lớp 2 chức năng cao cấp - Thảo Kiên,Thảo Kiên,229000,Việt Nam,"Áo mưa, ô dù và phụ kiện đi mưa",229000,0,0
6923721,Combo 02 Gói thuốc diệt chuột Storm 0.005% Gói 20 viên,STORM,44995,Việt Nam,"Hoa tươi, Cây cảnh & Hạt giống",44995,0,0
14640240,Cân Điện Tử Nhà Bếp 5kg - Cân Chia Thực Phẩm Nhà Bếp - Cân Tiểu Ly 5kg,OEM,95000,Trung Quốc,Dụng cụ làm bánh,95000,0,0
274994446,Nấm sứ bình lọc nước Hàn Quốc loại tốt (trắng),Rainy,69000,Korea,"Bình lọc, lõi lọc, thiết bị lọc nước",69000,0,0
11345052,Đất hữu cơ trồng cây đa dụng ( 6.5 dm3 ),Lavamix,16500,Việt Nam,"Hoa tươi, Cây cảnh & Hạt giống",16500,0,0
170700257,"Chổi Quét Trần Nhà, Chổi Phất Trần Có Cán Điều Chỉnh Độ Dài Quét Mạng Nhện, Lau Chùi Bụi Bẩn Trên Cao Tiện Dụng - Henrysa",HENRYSA Bạn của mọi nhà,89000,Trung Quốc,Dụng cụ lau nhà,150000,61000,41
273509067,"Bàn Chải Chà Sàn 2in1, Chổi Quét Nước Kiêm Cây Lau Kính Tiện Lợi",PEAFLO,35000,HK/TQ,Dụng cụ vệ sinh,55000,20000,36
189849768,"Băng Keo Nhám Chống Trơn Trượt Cầu Thang, Bậc Cửa Oto",NAVIVU,95000,Trung Quốc,Dụng cụ sửa chữa nhà cửa,95000,0,0
275837551,Bình nước thủy tinh saffron Kingdom Herb cao cấp 500ml,Kingdom Herb,23000,Việt Nam,,39000,16000,41
208413993,Bàn Làm Việc Phong Cách Bắc Âu Thương Hiệu IGA (Không Bao Gồm Ghế) - GP86,IGA,239000,Việt Nam,"Nội thất phòng học, làm việc",239000,0,0
128969410,"Kệ Sách Để Bàn, Giá Sách Thiết Kế Hiện Đại Thương Hiệu IGA - GP157",IGA,205000,Việt Nam,"Nội thất phòng học, làm việc",205000,0,0
578967,Chảo Đá Chống Dính Siêu Bền Sunhouse SBD28 28cm,Sunhouse,271040,Việt Nam,Nồi và chảo,430000,158960,37
275570184,Bình đựng thức ăn giữ nhiệt inox 304 Elmich EL8337 dung tích 650ml,Elmich,205200,Trung Quốc,Bình/ Ly giữ nhiệt,450000,244800,54
272558337,"Bàn làm việc, bàn học chân sắt thiết kế kèm giá sách 2 tầng rất tiện lợi, mặt bàngỗ công nghiệp được bo góc để trách va đập",Nội Thất 5C,734000,Việt Nam,"Nội thất phòng học, làm việc",1250000,516000,41
204046604,"Ghế xoay văn phòng,ghế văn phòng AD010",Ánh Dương,429000,Việt Nam,"Nội thất phòng học, làm việc",429000,0,0
275338444,Móc Inox Dán Tường Chịu Lực 15KG Hamart Móc Treo Đồ Nặng Dán Tường Chất Lượng Cao,GUANG MING,15000,Trung Quốc,,25000,10000,40
242086158,Dù Che Mưa SMARTCHOICE – Ô Dù Gấp Gọn Cao Cấp 3 Lớp Chống Tia UV Có Hộp Đựng Thời Trang,SmartChoice,179000,Trung Quốc,"Áo mưa, ô dù và phụ kiện đi mưa",179000,0,0
108922782,"Biến áp đổi nguồn LIOA 220V sang 100V 110V 120V (200VA, 400VA, 600VA, 1000VA, 1200VA, 1500VA, 2000VA)",LiOA,316000,Việt Nam,"Ổ cắm, ổn áp, biến áp",316000,0,0
7221847,"Bộ Nồi Inox Sunhouse Mama cao cấp 5 đáy SH784 (16cm, 20cm, 24cm) - Dùng cho mọi loại bếp - Hàng chính hãng",Sunhouse,712800,Việt Nam,Nồi và chảo,1340000,627200,47
161029925,"Cây gạt nước sàn nhà Kitimop-G35 chổi gạt nước silicon nhà tắm, cán thép không gỉ tăng giảm chiều dài",Kitimop,119000,Việt Nam,Dụng cụ lau nhà,195000,76000,39
69237854,"Ổ khóa cao cấp Toplex, chống cắt vuông, 1203-40mm",TOPLEX,90000,China,Bảo vệ nhà cửa,90000,0,0
272411943,Bình giữ nhiệt gia đình inox 304 Elmich EL8299 dung tích 900ml - Hàng chính hãng,Elmich,353400,Trung Quốc,Bình/ Ly giữ nhiệt,550000,196600,36
77448059,Cốc giữ nhiệt LocknLock LHC4247PIK Table Mug 473ml,LocknLock,254000,Trung Quốc,Bình/ Ly giữ nhiệt,484000,230000,48
135442380,"Bộ Tua Vít Đa Năng 6 Chiếc Deli Cao Cấp Chính Hãng - Nhỏ Gọn, Tiện Ích, Dễ Dàng Sử Dụng - Thiết Thể Đẹp Mắt - EDL3206",Deli,29000,Trung Quốc,Các loại máy và phụ kiện,52200,23200,44
275213009,Bình Nước Trẻ Em 450ml HOKORI Chất Liệu Nhựa PP Nguyên Sinh Không BPA An Toàn Tuyệt Đối Cho Bé - Hàng chính hãng,Hokori,99000,Trung Quốc,,198000,99000,50
274054379,Bộ nồi chảo chống dính Elmich baby EL-1168 size16cm,Elmich,359100,Việt Nam,Nồi và chảo,699000,339900,49
106948794,"Móc dán tường siêu dính, móc dán tường treo đồ nặng, nồi niêu, xong chảo, móc treo đồ đa năng",MO hi,19800,Trung Quốc,,22000,2200,10
260040913,"Phân Gà Greenhome, Aki Sfarm, Bao 1kg, Nhập Khẩu Nhật, Viên Nén, Hữu Cơ Sinh Học Bón Rau Sạch, Cây Ăn Quả, Hoa Hồng",Đặng Gia Trang,28900,Nhật Bản,"Hoa tươi, Cây cảnh & Hạt giống",50000,21100,42
198295325,"Nồi hấp trong lò vi sóng LocknLock bằng nhựa , 1.2L - màu xám - LMW123",LocknLock,128000,Hàn Quốc,Nồi và chảo,231000,103000,45
186254300,Ga chống thấm một màu Lidaco đủ size nệm (màu ngẫu nhiên),LIDACO,55000,Việt Nam,,60000,5000,8
225191298,"Cân điện tử GDA001 cân nhà bếp 5kg, chia thực phẩm, cân tiểu ly electronic Kitchen tặng kèm 1móc dán trong và pinAAA- Hàng chính hãng",KINGO,85000,China,Dụng cụ làm bánh,105000,20000,19
274435840,Công tắc điều khiển từ xa HT-6220KG 40A 1000m và 3000m,HUNONIC,135000,Việt Nam,Thiết bị điều khiển thông minh,135000,0,0
176691427,Thùng Rác Đạp Chân Hình Chữ Nhật Nhiều Cỡ Kèm Ruột Hiro Hàng Xuất Nhật - Chính Hãng ( Tặng kèm bộ 3 khăn lau pakasa) Giao màu ngẫu nhiên,Inochi,199000,Việt Nam,Dụng cụ vệ sinh,199000,0,0
119195755,"Bộ lau nhà tự vắt thông minh, chổi lau nhà 360 độ, lau sạch khô nhanh - Parroti ProMax PX01",Parroti,474050,Trung Quốc,Dụng cụ lau nhà,499000,24950,5
208218743,Kệ giày gỗ 3 4 5 tầng thương hiệu IGA GP247,IGA,205000,Việt Nam,Nội thất phòng khách,205000,0,0
781987,Gối Memory Foam 50D Lock & Lock HLW114 (61 x 34 x 10 cm),LocknLock,416000,Trung Quốc,"Gối, ruột gối, vỏ gối",791000,375000,47
271120475,Đệm Ngồi 3D Silicon 2 Lớp Tổ Ong Lót Ghế Thoáng Khí Chống Đau Mỏi Lưng,PEAFLO,145000,HK/TQ,Nội thất phòng khách,185000,40000,22
201346805,Trung Nguyên Legend - Phin nhôm hoa văn Trống Đồng có hộp,Trung Nguyên Legend,56000,Việt Nam,"Bình, ly uống cà phê và phụ kiện",56000,0,0
183907622,"Cây Lăn Bụi Quần Áo, Ghế Sofa - Tặng Kèm 2 lõi lăn",PEAFLO,39000,Thái Lan / Trung Quốc / Malaysia (Tùy từng đợt nhập hàng),Phụ kiện giặt ủi,55000,16000,29
38309801,Vỉ 5 Viên Pin CR1220 ( CR 1220/5BE x 1 Vỉ ) Lithium 3V Panasonic - Hàng Chính Hãng,Panasonic,95000,Indonesia,Pin và dụng cụ sạc pin,100000,5000,5
74986804,"Túi đựng hộp cơm cao cấp. Túi giữ nhiệt đa năng nhiều lớp. Túi đựng đồ ăn trưa. Túi chống toả nhiệt, dày dặn, phong cách Hàn Quốc thời trang, hiện đại KORESTAB8001",Weyoung,125000,Việt Nam/ Trung Quốc/ Đức,Phụ kiện nhà bếp,125000,0,0
477936,Lõi Lọc Kova-Barrier Tiêu Chuẩn - FC-STD,BARRIER,194000,,"Bình lọc, lõi lọc, thiết bị lọc nước",250000,56000,22
46163430,Sáo Recorder Soprano Yamaha YRS-24B Tone C (Đô) Hàng Chính Hãng,Yamaha,129000,Trung Quốc,Nhạc cụ hơi,129000,0,0
8380873,Ủng Bọc Giày Đi Mưa Dùng Nhiều Lần,OEM,85000,HK/TQ,"Áo mưa, ô dù và phụ kiện đi mưa",85000,0,0
207646663,"Ấm Pha Trà Thủy Tinh Heisou Có Lõi Lọc, Dung Tích 750ml, Chịu Nhiệt Tốt - Hàng Nhập Khẩu",DORON the best service,169000,Trung Quốc,"Bình, ly uống trà và phụ kiện",169000,0,0
4482993,"Kính bảo hộ lao động, kính chống bụi cao cấp, dùng ngoài kính cận 3M Tourguard 5",3M,75000,Mỹ,Bảo hộ lao động,75000,0,0
15444566,Kệ đựng xà bông dán tường gạch men có miếng dán Hobby Home Decor SBL2,Hobby Home Decor,65000,Trung Quốc,,68000,3000,4
57335326,"Ghế xếp thư giãn SUMIKA 179A - Khóa kim loại, khung thép tròn, tải trọng 200kg",Sumika,760000,Trung Quốc,Nội thất phòng khách,1000000,240000,24
275284150,"Dụng cụ thông tắc bồn cầu, cống bằng khi nén áp lực siêu mạnh",PEAFLO,220500,Thái Lan / Trung Quốc / Malaysia (Tùy từng đợt nhập hàng),Dụng cụ vệ sinh,225000,4500,2
528943,Màng Bọc Thực Phẩm PVC Laspalms - 30cmx368m,Laspalms,179000,Việt Nam,Phụ kiện nhà bếp,335500,156500,47
70840667,Pin Energizer Specialty ECR2032 Vỉ 1 Viên,Energizer,32800,Indonesia,Pin và dụng cụ sạc pin,32800,0,0
130978475,Đèn Pin LED Điện Quang ĐQ PFL08 R (Pin sạc),Điện Quang,120000,Trung Quốc,,146606,26606,18
115436781,Đèn Fairy Light Năng Lượng Mặt Trời Điều Khiển Remote,OEM,270000,Trung Quốc,Đèn ngoài trời,270000,0,0
113175085,Đèn Học Để Bàn Chống Cận Rạng Đông RD-RL-36.LED - 6W,Rạng Đông,210000,Việt Nam,Đèn học và đọc sách,210000,0,0
275072447,"Chân, giá đỡ đàn guitar chắc chắn VInes",Vines,114000,Trung Quốc,Phụ kiện đàn,150000,36000,24
195797725,Thớt tre tự nhiên Sunhouse KS-CH3522B,Sunhouse,99000,Việt Nam,Phụ kiện nhà bếp,153000,54000,35
56679961,Combo 10 Miếng Xốp Dán Tường Giả Gạch Dày 4mm,OEM,195000,Việt Nam,Decal & giấy dán tường,245000,50000,20
52774383,Đèn LED Đom Đóm Chipsbling Dùng Pin Năng Lượng Mặt Trời,OEM,120000,Trung Quốc,,120000,0,0
214667399,"Băng Keo Chống Trượt, Miếng Dán Bậc Cầu Thang Bằng Nhựa PVC Dài 1 Mét Sẵn Keo 3M Siêu Dính, Anh Toàn Legaxi",Legaxi,34000,Trung Quốc,Dụng cụ sửa chữa nhà cửa,34000,0,0
190857176,"Đất Trồng Kiểng Lá Greenhome, Bao 10 Lít (3kg), Giá Thể Trộn Sẵn, Tiện Lợi Cho Monstera, Rễ Khoẻ, Thân To, Lá Dày",Greenhome,74900,Việt Nam,"Hoa tươi, Cây cảnh & Hạt giống",124200,49300,40
274691734,"Bộ lau nhà GOSO Plus có thùng lau nhà 2 ngăn tự vắt, cây lau nhà xoay 360 độ giúp lau sàn làm sạch",PEAFLO,249000,Hàn Quốc / Trung Quốc,Dụng cụ lau nhà,345000,96000,28
203585002,"[PHIÊN BẢN MỚI] Dây Tắm Xơ Mướp Cao Cấp ECODEALS 100% xơ mướp hữu cơ diệt khuẩn - Mềm mại, nhẹ nhàng tẩy da chết, ngừa mụn lưng, kỳ cọ và massage siêu đã - 1 cái KT 10 x 30 x 80 cm",ECODEALS,82000,"Việt Nam / Hàn Quốc / Ấn Độ / Trung Quốc,...",Phụ kiện nhà tắm,105000,23000,22
144635982,"Hạt Giống Hoa Sao Nhái Nhiều Màu, Dễ Trồng, Hoa Ra Liên Tục",Hạt giống Rạng Đông,9506,Việt Nam,"Hoa tươi, Cây cảnh & Hạt giống",9700,194,2
27948515,"Bộ 2 móc treo chổi, cây lau nhà dụng cụ tẩy rửa nhà tắm dán tường chống khuẩn tiết kiệm không gian chịu lực tối đa 5Kg",OEM,36000,,,36000,0,0
122700651,"Cây lau kính, gạt chùi kính đa năng 2 đầu trong 1 - Parroti Shiny SN01",Parroti,122550,Trung Quốc,Dụng cụ lau nhà,129000,6450,5
50701305,Vợt muỗi SUNHOUSE SHE-S800,Sunhouse,96000,Trung Quốc,"Dụng cụ diệt chuột, côn trùng",150000,54000,36
275278125,Set 10 Móc Treo Quần Áo Chống Trượt Xoay 360 Đa Năng Bằng Nhựa Cao Cấp Bền Chịu Được Vật Nặng,PEAFLO,85000,Trung Quốc/ Hàn Quốc/ Việt Nam/ Philipin,Phụ kiện giặt ủi,110000,25000,23
273608471,"[GIFT] Thảm chùi chân nhà tắm, phòng khách, nhà bếp cao cấp",Damas,76000,Trung Quốc,Phụ kiện nhà tắm,80000,4000,5
195109412,"Bộ nồi Inox dập nguyên khối Elmich Trimax Classic EL-2110OL Size 18, 20, 24, chảo 26cm",Elmich,1750000,Trung Quốc,Nồi và chảo,3550000,1800000,51
276111530,"Bộ điều khiển Tivi, Máy lạnh [từ xa bằng điện thoại] Hunonic IR Smart | Điều khiển Tất cả các thiết bị Hồng ngoại từ xa - Irsmart",HUNONIC,195000,Việt Nam,Thiết bị điều khiển thông minh,195000,0,0
171198348,"Ghế Xoay Văn Phòng Công Thái Học Ergonomic Có Ngả Lưng Gác Chân TANNI Premium 02 Plus, Ghế Xoay Gaming Cao Cấp Nhập Khẩu",TANNI,1173000,Đài Loan,"Nội thất phòng học, làm việc",2390000,1217000,51
195791850,Chảo chống dính Ultra titanium Sunhouse ST20B - Dùng cho mọi loại bếp - Hàng chính hãng,Sunhouse,384560,Việt Nam,Nồi và chảo,650000,265440,41
32328782,Trung Nguyên Legend - Phin nhôm hoa văn màu đen Vĩ Nhân,Trung Nguyên,76000,Việt Nam,"Bình, ly uống cà phê và phụ kiện",76000,0,0
195980111,Bình giữ nhiệt LocknLock LHC3275 - 490ML - Hàng chính hãng,LocknLock,257000,Trung Quốc,Bình/ Ly giữ nhiệt,490000,233000,48
270504280,Tủ giày nhựa 2 cánh Sunhouse KS-CA726S - Xám Trắng,Sunhouse,475200,Việt Nam,Nội thất phòng khách,950000,474800,50
145760683,Thảm chân Vải Mềm Phòng Khách Nhà Tắm Nhà Bếp Siêu Thấm Nước,PEAFLO,48000,Trung Quốc / Singapore / Việt Nam,Phụ kiện nhà tắm,69000,21000,30
42759652,Chốt cửa dây xích an toàn inox 304 gắn cửa HOBBY Home Decor KLC1 bảo vệ phòng cho chung cư phòng ngủ không rỉ sét,Hobby Home Decor,81000,Trung Quốc,Bảo vệ nhà cửa,129000,48000,37
273009767,"Áo Mưa 1 Người Trong Suốt Eva Deli - Siêu Dày Chống Thấm Nước Cho Mưa To Phong Cách Thời Trang Nhiều Màu Sắc Tươi Trẻ, Phù Hợp Cho Cả Nam Nữ",Deli,25000,Trung Quốc,"Áo mưa, ô dù và phụ kiện đi mưa",45000,20000,44
198462390,Nồi inox liền khối Elmich Hera,Elmich,455400,Việt Nam,Nồi và chảo,990000,534600,54
135442367,Mỏ Lết Đa Năng Deli Cao Cấp 16-68mm - Tiện Dụng Cho Công Việc Sửa Chữa - Chất Liệu Thép Chống Ăn Mòn Chắc Chắn DL120108,Deli,79000,Trung Quốc,Dụng cụ sửa chữa nhà cửa,142200,63200,44
16376462,Bao Giày Đi Mưa - Áo Mưa Giày Dép Thời Trang Bằng Cao Su Khô Ráo Dù Mưa Bão,OEM,38900,,"Áo mưa, ô dù và phụ kiện đi mưa",38900,0,0
276178932,Đui đèn cảm ứng hồng ngoại chuyển động thông minh tự bật sáng khi có người ILH-BI,Posson,48888,Trung Quốc,Bóng và linh kiện đèn,48888,0,0
225947119,"Vòi sen tắm KG155 tăng áp lực nước gấp 3 lần, siêu tiết kiệm nước lọc nano, dùng được nước nóng lạnh inox304 - Hàng chính hãng",KINGO,115000,Việt Nam,Thiết bị phòng tắm,150000,35000,23
275440949,"Bật Lửa Mồi Bếp Gas, Bếp Cồn An Toàn (Màu Sắc Ngẫu Nhiên) Dụng Cụ Mồi Lửa Cho Bếp Cồn, Bếp Gas Gia Đình, Quán Ăn",eData,24000,Việt Nam,"Bếp nướng, vỉ nướng",24000,0,0
273383705,Đèn năng lượng mặt trời chống lóa Vạn Năng Solar 300w,Vạn Năng Solar,929000,Trung Quốc,Đèn ngoài trời,1100000,171000,16
15453283,Bộ 3 Hộp thủy tinh tròn Lock&Lock LLG822 400ml tặng túi giữ nhiệt,LocknLock,154800,,Dụng cụ chứa đựng thực phẩm,154800,0,0
125666588,Đũa Vuông Inox 304 Chống Trượt Soika - Hộp 10 Đôi ,Soika,245000,Trung Quốc,"Đũa, muỗng, nĩa",309000,64000,21
217750982,"Đầu gắn vòi nước rửa chén KG16, xoay 360 tăng áp tiết kiệm nước phù hợp được tất cả các vòi, chất liệu inox304 - Hàng chính hãng",KINGO,77000,Việt Nam,Phụ kiện nhà bếp,135000,58000,43
176592356,Bông lau nhà chữ nhật đa năng Sunhouse KS-CO3211S,Sunhouse,36100,Việt Nam,Dụng cụ lau nhà,45000,8900,20
55669191,"Đèn Pixar, Đèn Học Chống Cận Thị, Đèn Đọc Sách, Đèn Làm Việc Để Bàn Chống Chói Mắt Lóa Mắt Bảo Vệ Mắt - Hàng Chính Hãng",miDoctor,178000,,Đèn học và đọc sách,206000,28000,14
174262175,Bát Sen Tắm Của Vòi Tắm Hoa Sen Nóng Lạnh Pimisi Với Tay Sen Bằng Nhựa Cao Cấp Mạ Xi Cr/Ni Màu Inox Sáng Bóng Kiểu Vuông Bo Tròn Góc - Ổn Định Nhiệt Độ Nước Nóng Lạnh Theo Công Nghệ Đầu Phun Tăng Áp Dạng Phun Mưa Tiết Kiệm Nước | Hàng Chính Hãng,Pimisi,124000,Việt Nam,Thiết bị phòng tắm,200000,76000,38
170354329,KHUNG VÕNG XẾP DUY LỢI THÉP - CỠ LỚN (KHÔNG BAO GỒM VÕNG LƯỚI) - TẶNG 10 MÓC ÁO KÉP NHỰA CAO CẤP DUY LỢI,Duy Lợi,759000,Việt Nam,Phụ kiện phòng ngủ,759000,0,0
271978704,"Miếng Nam Châm Siêu Hút Dán Tủ Lạnh, Bảng Đen Kèm Keo 2 Mặt",NAVIVU,15000,Trung Quốc,Dụng cụ sửa chữa nhà cửa,15000,0,0
153546308,"Phân bón hoa lan BIOGROW kích thân mầm lá, siêu kích kie lan, mầm to, cành khỏe, dung tích 500ml, chính hãng DOCNEEM",DocNeem,119000,Việt Nam,"Hoa tươi, Cây cảnh & Hạt giống",119000,0,0
197340942,Bộ Tuốc Nơ Vít Crownman 5 trong 1 - 0605605,Crownman,60000,Trung Quốc,Các loại máy và phụ kiện,72000,12000,17
7114705,Đèn Pin Đội Đầu Sunhouse Cỡ Trung SHE 5032,Sunhouse,91000,Việt Nam,,156000,65000,42
269962803,"Bút kiểm tra chất lượng nước 5 trong 1, bút đo độ PH, độ mặn , TSD, EC cso đèn nền - hàng chính hãng",VINETTEAM,329000,Trung Quốc,Thiết bị đo lường,329000,0,0
578902,Chảo Đáy Từ Chống Dính Sunhouse SHM26 26cm,Sunhouse,199000,Việt Nam,Nồi và chảo,300000,101000,34
203898025,"Keo dính chuột siêu dính dài 120cm, miếng dán chuột, bẫy chuột, không ẩm ướt, tái sử dụng nhiều lần không độc hại",OEM,73000,Trung Quốc,"Dụng cụ diệt chuột, côn trùng",73000,0,0
196201377,"Miếng Lót Ly Họa Tiết Terrazzo, Đế Lót Đá Xốp Diatomite Siêu Thấm Hút",NAVIVU,35100,Trung Quốc,"Ly, cốc & phụ kiện ly",35100,0,0
274067033,Ổ cắm điện Philips CHP2140WB - 3m,Philips,150000,Trung Quốc,"Ổ cắm, ổn áp, biến áp",189000,39000,21
138336249,"Kệ Sách Tổ Ong Vân Gỗ FIVO FB01, Có Tấm Lưng Dày Dặn, Đa Năng Dùng Để Làm Giá Sách, Kệ Giày, Kệ Tivi, Tủ Đầu Giường - Hàng Chính Hãng",SPEVI,171000,Việt Nam,"Nội thất phòng học, làm việc",281000,110000,39
36327714,Combo 5 miếng keo dán chuột Đại thành,Đại Thành,54000,Việt Nam,"Dụng cụ diệt chuột, côn trùng",54000,0,0
6175665,Bộ Cây Lau Nhà Xoay Tay 2 Bông Lau Lock&Lock Corner ETM494 (330 x 235 mm) - Xanh Biển,LocknLock,490000,Trung Quốc,Dụng cụ lau nhà,800000,310000,39
274959742,"Túi đựng quần áo, chăn màn size lớn 1000L, có khoá kéo cao cấp- Hàng chính hãng",Nhà của Mẹ,90000,Việt Nam,Phụ kiện giặt ủi,90000,0,0
275465450,Khăn Tắm Hải Cẩu BHD6 50x100cm,Mollis,64000,"Anh, Việt Nam",Khăn,64000,0,0
195967978,Khăn Tắm Nén Du Lịch Bằng Cotton Tiện Lợi Dùng Một Lần 70*140cm - Khăn Nén Spa - Chính Hãng,lilahome,25000,Trung Quốc,Khăn,45000,20000,44
194496895,Chặn cửa chân móng ngựa có lẫy gạt chống va đập Hobby Home Decor CMG1,Hobby Home Decor,85000,Trung Quốc,Bảo vệ nhà cửa,139500,54500,39
274974855,"Lưới Lọc Tóc Dán Nắp Cống, Chặn Côn Trùng, Chống Tắc Nghẽn",NAVIVU,17000,Trung Quốc,Phụ kiện nhà tắm,17000,0,0
175971475,SF-300 Đầu Vòi Sen Tắm Tăng Áp Và Thanh Lọc Nước AQUADUO,AquaDuo,222000,Hàn Quốc,Thiết bị phòng tắm,288000,66000,23
21260228,Combo 4 móc treo đồ quần áo dán tường inox 304 HOBBY Home Decor V35-4,Hobby Home Decor,116000,Trung Quốc,Phụ kiện giặt ủi,235000,119000,51
67811819,"Đèn LED Cảm Biến Chuyển Động Nhiều Kích Cỡ, Cảm Ứng Hồng Ngoại 3 Chế Độ",OEM,179000,Trung Quốc,,179000,0,0
192411583,Đồng Hồ Hẹn Giờ Cơ Học 60 Phút Có Nam Châm Hít,NAVIVU,104000,Trung Quốc,Đồng hồ,104000,0,0
126596539,Pick-Phím gảy đàn guitar Dunlop 417P-Hàng nhập Mỹ,Dunlop,25000,Mỹ,Phụ kiện đàn,25000,0,0
7672597,Nhang Nụ Trầm Hương Kỳ Anh NT01,Trầm Hương Kỳ Anh,150000,,,150000,0,0
275418195,Két Sắt Ống Heo Tiết Kiệm Hình Ngôi Nhà Có Khóa Mini Cho Bé PaKaSa,PaKaSa,49000,Thailand / China / Malaysia (Tùy từng đợt nhập hàng),Nội thất phòng ngủ,98000,49000,50
52293501,"Túi Giữ Nhiệt Túi Đựng Hộp Cơm Chống Thấm Cao Cấp, Giữ Nhiệt Tốt, Nhỏ Gọn, Nhiều Màu Sắc",OEM,40000,,Phụ kiện nhà bếp,40000,0,0
247305229,"Cọ Rửa Cán Gỗ Cỡ Lớn Rửa Bình Sữa, Bình Nước, Ly Tách",NAVIVU,19500,Trung Quốc,Phụ kiện nhà bếp,19500,0,0
28079716,Hộp đựng xà phòng dầu gội sữa tắm Xinda ZYQ138 White,Xinda,135000,,Phụ kiện nhà tắm,135000,0,0
83431669,Đồng Hồ Để Bàn Casio TQ-369-7DF Có Đèn - Chuông Báo Thức - Kích Thước ( 11.6×13×9 cm ),Casio,594800,Trung Quốc,Đồng hồ,685000,90200,13
273170621,"Thùng Rác Treo Tủ Bếp Có Nắp Đậy Thông Minh, Thùng Rác Treo Tường Dán Tường Có Thanh Treo Cửa Tủ Bếp FEIDASH - Hàng Chính Hãng",feidash,136000,Trung Quốc,Dụng cụ vệ sinh,280000,144000,51
52416730,Tấm Che Bịt Mắt Có Túi Gel Làm Mát Giảm Căng Thẳng Kích thước 19x10 cm- Giao ngẫu nhiên,OEM,40000,Trung Quốc,Phụ kiện phòng ngủ,62000,22000,35
275197432,Thanh Treo Đa Năng Không Cần Khoan Tường Thanh Treo Quần Áo Treo Khăn Nhà Tắm Gắn Tường,PEAFLO,58000,Thái Lan / Trung Quốc / Malaysia (Tùy từng đợt nhập hàng),Phụ kiện giặt ủi,85000,27000,32
20104505,Hộp 3 ống hút inox và cọ rửa,OEM,49000,,"Ly, cốc & phụ kiện ly",49000,0,0
2395003,Khăn lau đa năng cao cấp 3M xanh dương 36cm,3M,55000,Việt Nam,Phụ kiện phòng ăn,55000,0,0
78964736,"Chốt Khóa Cài Cửa Có Lỗ Cài KUNBE, Chốt Cửa Khóa Gài Cây Gạt, An Toàn Cao Cấp Tiện Dụng",KUNBE,32000,Việt Nam,Bảo vệ nhà cửa,32000,0,0
181972675,Ủng Bọc Giày Đi Mưa Chống Nước Có Đế Chống Trơn Trượt Cao Cấp,OEM,39000,Trung Quốc,"Áo mưa, ô dù và phụ kiện đi mưa",39000,0,0
195856955,Bàn làm việc chân gấp gọn mặt gaming - TIDO TI-BGGGM - Mặt bàn dài 1m - 1m2 - Có 2 màu viền đỏ & đen,TIDO noithatTIDO.vn,595000,Việt Nam,"Nội thất phòng học, làm việc",700000,105000,15
99614537,"Kệ dán tường đựng xà phòng hình cá heo, có lỗ thoát nước - Hàng chính hãng, giao màu ngẫu nhiên",MO hi,25000,Trung Quốc,,25000,0,0
195448671,Bộ Lau Kính 2 Mặt Nam Châm Thông Minh MIFAN - Làm sạch cửa kiếng hai mặt nhà cao tầng chung cư - Nút điều chỉnh lực hút - Hàng chính hãng,Mifan,600000,Trung Quốc,Dụng cụ lau nhà,600000,0,0
121268659,Nắp đậy - giỏ lọc rác inox 304 của chậu rửa bát chén Pimisi | hàng chính hãng,Pimisi,28000,Việt Nam,Phụ kiện nhà bếp,40000,12000,30
14467293,Đèn Bắt Muỗi Điện Quang ĐQ EML01 không dùng hóa chất để thu hút muỗi độc hại ( Hàng chính hãng ),Điện Quang,165000,,,165000,0,0
57243045,"Cuộn 10 Mét Ron Dán Khung Cửa Giảm Tiếng Ồn Va Đập, Ngăn Bụi, Ngăn Côn Trùng Size  4 mm 6 mm 8 mm 10 mm - Hàng Chính Hãng",3M,70000,Trung Quốc,Bảo vệ nhà cửa,109000,39000,36
242628125,"Set 5 Miếng Hít Chân Không Siêu Chắc Đa Năng, Hít Cửa Kính Oto, Treo Đồ Nhà Tắm",NAVIVU,19000,Trung Quốc,,19000,0,0
190857201,"Vỏ Thông Greenhome, Newzita, Bao 500gr, Đã Qua Xử Lý, Trồng Lan, Kiểng Lá, Sen Đá, Rãi Bề Mặt Chậu Cây",Greenhome,21900,Việt Nam,"Hoa tươi, Cây cảnh & Hạt giống",40000,18100,45
274933664,"Ấm Đun Nước 5L Inox HiLOGI KITCHEN Dùng Được Bếp Từ ,Các Loại Bếp, quai xách chắc chắn bọc nhựa chống nóng",HiLOGI KITCHEN,149000,Trung Quốc,,149000,0,0
193723418,Lót Ly Siêu Thấm Diatom Mud Họa Tiết Gạch Terrazzo,NAVIVU,26000,Trung Quốc,"Ly, cốc & phụ kiện ly",26000,0,0
273467083,"Găng tay bảo hộ Safety jogger Shield  chống cắt cấp độ 5 (C), bao tay lớp phủ pu dày, chống rách, chống đâm xuyên, ôm tay",Safety Jogger,80000,Trung Quốc,Bảo hộ lao động,80000,0,0
984252,Kèn Melodion - Melodica Suzuki Study-32 32 Phím,SUZUKI,599000,Trung Quốc,Nhạc cụ hơi,599000,0,0
89992214,Kệ Góc Nhà Tắm INOX 304 dán tường gạch men siêu chắc,OENON,69000,Trung Quốc,,125000,56000,45
275665131,"Đèn năng lượng mặt trời chóng chói Vạn Năng Solar 100W, 200W, 300W",Vạn Năng Solar,659000,Trung Quốc,Đèn ngoài trời,699000,40000,6
53547712,Bàn xếp học sinh vân gỗ mini 30X50X22,Phương Lâm,135000,Việt Nam,"Nội thất phòng học, làm việc",135000,0,0
94891198,Hộp Cơm Giữ Nhiệt INOX304 Hiện Đại Kèm Hộp Đựng Canh Soup và Bộ Đũa Thìa INOX – Chất Liệu Cao Cấp An Toàn Cho Sức Khỏe – Hàng Chính Hãng Vinbuy,VinBuy,285000,Việt Nam/ Trung Quốc/ Đức,Bộ hộp cơm và phụ kiện,500000,215000,43
140791193,Bóng đèn LED Bright PHILIPS E27 - Thay thế hoàn hảo cho bóng đèn Compact - Hàng Chính Hãng,Philips,56000,Trung Quốc,Bóng và linh kiện đèn,90000,34000,38
248798331, Ổ Cắm Wifi Thông Minh TP-Link Tapo P100 - Hàng Chính Hãng,TP-Link,189000,Trung Quốc,"Ổ cắm, ổn áp, biến áp",226000,37000,16
579962,"Bộ Nồi 5 Đáy Cao Cấp Núm Vàng Sunhouse SH781 Quay Mạ Vàng Cao Cấp (16cm, 20cm, 24cm) - Dùng Cho Mọi Loại Bếp - Hàng Chính Hãng",Sunhouse,528000,Việt Nam,Nồi và chảo,960000,432000,45
269992441,Hộp cơm giữ nhiệt văn phòng cap cấp Mitomo LCH-7086 chính hãng - Bảo hành 12 tháng,Mitomo,550000,Thái Lan,Bộ hộp cơm và phụ kiện,1059000,509000,48
275433036,Vòi Rửa Chén Bát Hoa Sen Xoay 360 Độ Chống Văng Chống Bắn Đầu Vòi Nước Mở Rộng Tiết Kiệm Nước Tiện Ích Cho Mọi Gia Đình,eData,9000,Trung Quốc,Phụ kiện nhà bếp,9000,0,0
199593599,Kệ Sách Hình Cây Để Sàn,IGA,245000,Việt Nam,"Nội thất phòng học, làm việc",245000,0,0
167423027,Combo 3 bóng Philips LED bulb Essential E27 9w ánh sáng trắng 6500K,Philips,114400,Trung Quốc,Bóng và linh kiện đèn,262500,148100,56
181909427,Nồi 2 Tay Cầm Suit LocknLock CSU1202PIK - Màu Pink,LocknLock,558000,Trung Quốc,Nồi và chảo,1112000,554000,50
274144154,"Áo mưa bộ vải dù cao cấp  có túi đựng ,dày ,nhỏ gọn tiện lợi siêu bền ,chống thấm  dùng cho nam và nữ",XUDI,154000,Việt Nam,,159000,5000,3
58459239,Phân bón đầu trâu MK NPK 17-15-7+TE cao cấp gói 1KG chuyên hoa - cây cảnh,Bình Điền,50960,Việt Nam,"Hoa tươi, Cây cảnh & Hạt giống",50960,0,0
275245443,"Bạt nhựa PE định lượng 250gsm che nắng, mưa - Bạt được may viền khuy chắc chắn, dễ sử dụng",N NN VIETNAM In Quality We Different,75000,Việt Nam,Ngoại thất sân vườn,75000,0,0
24766023,Bộ Sạc Pin AA AAA + 4 Pin AA 1200mAh Doublepow (Hàng nhập khẩu),Doublepow,149000,,Pin và dụng cụ sạc pin,149000,0,0
178029980,Hộp 40 Viên Pin AA Maxell ( pin tiểu ) carbon Siêu Bền R6P (Đỏ) Maxell Super Power Ace,Maxell,19500,Indonesia,Pin và dụng cụ sạc pin,19500,0,0
129271226,"Bàn Học, Làm Việc  Gấp Gọn Đa Năng Thông Minh Phù Hợp Với Mọi Không Gian Có Khe Cắm Ipad, Điện Thoại- Hàng Chính Hãng MINIIN",MINIIN,64000,China / Vietnam,"Nội thất phòng học, làm việc",121000,57000,47
275613041,"Túi vải không dệt, túi lọc trà , túi đựng hạt hút ẩm size 5x7 cm (100 túi)",Túi ni lông tự phân hủy sinh học GIMEX II,29000,Việt Nam,Dụng cụ chứa đựng thực phẩm,29000,0,0
144203362,"Bộ túi hộp cơm thủy tinh Lock&amp;Lock 3EA LLG429DS2NVY (LLG429Dx1, LLG428x1, HWB820NVYx1) - Màu",LocknLock,363000,Trung Quốc,Bộ hộp cơm và phụ kiện,682000,319000,47
87873126,"Áo Mưa Bộ Vải Dù, Bộ Quần Áo Mưa Có Phản Quang Đủ Size, Chống Thấm Hiệu Quả, Phù Hợp Nam Và Nữ, Có Túi Đựng, Có Lựa Chọn Màu Sắc",XUDI,150000,Việt Nam,"Áo mưa, ô dù và phụ kiện đi mưa",150000,0,0
273303305,Đệm Mông Công Thái Học Cao Su Non Gối Ngồi Thoáng Khí Đệm Lót Ghế Văn Phòng Ô Tô Xe Hơi- Sairui,sr LIFE EXPERTS SAIRUI,299000,Trung Quốc,Nội thất phòng khách,299000,0,0
178068438,"Khăn giấy cuộn đa năng, lau bếp, lau kính, chén bát, lau tay (50 khăn/cuộn, 25cm x25cm) - Parroti Bingo NG01",Parroti,48900,Trung Quốc,Phụ kiện nhà bếp,48900,0,0
10768010,Đèn bắt muỗi Điện Quang ĐQ EML06L ,Điện Quang,305000,Trung Quốc,,305000,0,0
3677799,Hộp 6 Lõi  Lọc Nước BRITA Maxtra Plus Filter Cartridge,Brita,1139050,Đức,"Bình lọc, lõi lọc, thiết bị lọc nước",1849000,709950,38
68521325,Trung Nguyên Legend - Phin nhôm hoa văn Trống Đồng,Trung Nguyên,49000,Việt Nam,"Bình, ly uống cà phê và phụ kiện",49000,0,0
273043029,Lọ xay tiêu chạy pin Elmich PME 8513,Elmich,189050,Trung Quốc,Phụ kiện nhà bếp,380000,190950,50
193724496,"Xe kéo hàng 4 bánh gấp gọn 300kg Nhập Khẩu Nhật Bản FUJIHOME, bánh cao su siêu bền, xe chở đồ đẩy hàng gấp gọn đa năng giá rẻ - Hàng Nhập Khẩu",Fujihome,572300,Trung Quốc,Xe đẩy hàng,590000,17700,3
203188428,Kệ Để Giày Dép Chữ X Thông Minh Có Thể Tháo Lắp Gấp Gọn - Kệ Nhựa 5 Tầng Cao Cấp Để Đồ Trang Trí Đa Năng Tiện Dụng - CHÍNH HÃNG MINIIN,MINIIN,76000,Trung Quốc,Nội thất phòng khách,99000,23000,23
106563599,"Bóng đèn PHILIPS LED Bright E27-Công suất (9W, 11W, 13W, 15W, 17W) ánh sáng vàng, ánh sáng trắng",Philips,66400,Trung Quốc,Bóng và linh kiện đèn,89500,23100,26
35273810,"Keo vá tường,Keo trám vết nứt tường thông minh - Tặng kèm bộ dụng cụ",OEM,48000,Trung Quốc,Dụng cụ sửa chữa nhà cửa,48000,0,0
273427121,Tranh Cát Chuyển Động 3D Nghệ Thuật 25cm x 1.5cm- Hàng Chính Hãng ,PaKaSa,192780,Trung Quốc,Tranh trang trí,278000,85220,31
2917525,Chảo Gang Chống Dính Đổ Bánh Xèo Dragon,Dragon,115000,Việt Nam,Nồi và chảo,115000,0,0
275037041,Bộ quần áo đi mưa chất liệu vải dù siêu bền - Hàng chính hãng,Nhà của Mẹ,180500,China / Vietnam,"Áo mưa, ô dù và phụ kiện đi mưa",190000,9500,5
142261128,"Đệm Lót Ghế Ngồi NOOZ Home Goods Gối Lót Ghế Ngồi Bệt Memory Foam Giúp Chống Đau Lưng, Đau Xương Cụt, Đau Thần Kinh Tọa Ruột Đệm Cao Su Non Danh Cho Dân Văn Phòng",NOOZ,299000,Trung Quốc,"Gối, ruột gối, vỏ gối",450000,151000,34
150567627,"Ruột Gối Ôm Lông Vũ Microfiber A 35x100cm - tặng kèm túi xách đựng gối sang trọng màu ngẫu nhiên - Tạo giấc ngủ bồng bềnh, an toàn sức khoẻ",A,305000,Việt Nam,"Gối, ruột gối, vỏ gối",310000,5000,2
579932,Chảo Trơn Chống Dính Sunhouse CT20 20cm,Sunhouse,98500,Việt Nam,Nồi và chảo,140000,41500,30
275481695,[Quà tặng] Ly sứ cao cấp Highlands,Highlands Coffee,99000,Việt Nam,"Ly, cốc & phụ kiện ly",99000,0,0
146736019,Thiết Bị Đo Nhiệt Độ Và Độ Ẩm Xiaomi Mi Temperature And Humidity Monitor 2 (NUN4126GL),Xiaomi,160000,Trung Quốc,Thiết bị đo lường,160000,0,0
188835246,"Thảm Lót Ghế Làm Việc, Trải Sàn Văn Phòng; Chống Xước Sàn Gỗ, Không Thấm Nước, Chống Trơn Trượt - Hàng Nhập Khẩu",iKiU,219000,Trung Quốc,Trang trí nhà cửa khác,219000,0,0
205905589,"Khay đá hình tròn uống rượu vang CAO CẤP, khay làm đá hình tròn cho nhà hàng khách sạn cao cấp - Hàng chính hãng",FuNu,42750,Trung Quốc,Phụ kiện nhà bếp,45000,2250,5
147953627,"dụng cụ lọc gia vị, giỏ lọc gia vị bằng inox",COBI Home,159000,Trung Quốc,Phụ kiện nhà bếp,159000,0,0
22949739,Cuộn Băng Keo Trong Suốt Chống Thấm Nước Dán Siêu Dính Đa Năng Dính Trên Mọi Bề Mặt Cao Cấp,OEM,13000,Hàn Quốc / Trung Quốc,Dụng cụ sửa chữa nhà cửa,13000,0,0
190553620,Khăn Vải Đa Năng Tẩy Trang Lau Mặt Dùng Khô/Dùng Ướt,NAVIVU,46550,Trung Quốc,Khăn,49000,2450,5
32895306, Đèn Bàn Học Đọc Sách LED Chống Cận 03 Chế Độ Ánh Sáng Vàng Bảo Vệ Mắt ,OEM,149000,,,149000,0,0
20274848,"Túi Lưu Trữ Chăn Mền, Túi Đựng Quần Áo Phong Cách Nhật",OEM,55000,Trung Quốc,Phụ kiện phòng ngủ,55000,0,0
202233281," TOPPER NỆM TRẢI SÀN CAO CẤP GIẢM ĐAU MỎI VAI GÁI,CHỐNG ĐAU CỘT SỐNG,CHẤT COTTON kích thước 1m/1m2/1m4/1m6/1m8",FUKOJI,494000,Việt Nam,Nệm và phụ kiện,600000,106000,18
50824932,Cây treo quần áo 3 chân 8 nhánh treo bằng gỗ cao su màu tự nhiên,Viet Home Decor,380000,,Phụ kiện giặt ủi,380000,0,0
191378473,Nhang Nụ Đàn Hương cao cấp MỘC LÂM 100g 60 Viên Nụ Khói Ngược Xông Nhà Dùng Được Cho Thác Trầm Hương,mộc lâm,121439,Việt Nam,,129190,7751,6
275305670,"Thùng Rác Treo Tủ Bếp, Treo Nhà Vệ Sinh Nắp Lật 2 Chiều Bằng Nhựa PP Cao cấp - Hàng chính hãng (Màu ngẫu nhiên)",PaKaSa,104720,Trung Quốc,Dụng cụ vệ sinh,166000,61280,37
117195930,Pin Maxell Super Đỏ - Hộp 40 Viên Pin Tiểu AA (2A) 1.5V,Maxell,119000,Trung Quốc/Hàn Quốc/Mỹ/Thái Lan/Nhật Bản (tùy vào đợt hàng),Pin và dụng cụ sạc pin,119000,0,0
135442228,"Bộ Tua Vít Sửa Chữa Đa Chức Năng Deli Tools 21 Chi Tiết Cao Cấp - Chất Liệu Siêu Bền, Thiết Kế Gọn Nhẹ Tinh Tế - DL1021D",Deli,99000,Trung Quốc,Các loại máy và phụ kiện,178200,79200,44
252204734,Máy Bào Đá Mini Xay Đá Tuyết Quay Bằng Tay Đa Năng Cho Gia Đình - HÀNG CHÍNH HÃNG MINIIN,MINIIN,133000,Trung Quốc,,159000,26000,16
209305318,"Dép Nhựa Đi Trong Nhà, Nhà Tắm Hình  Sọc Lưới - Hàng Chính Hãng",EMHOME,42750,Trung Quốc,Phụ kiện nhà tắm,45000,2250,5
195469953,Súng Bắn Keo (Cỡ Lớn/Nhỏ) Kèm 10 Keo Nến Silicon,NAVIVU,95000,Trung Quốc,Dụng cụ sửa chữa nhà cửa,100000,5000,5
274858052,"khăn tắm, khăn tay, khăn mặt sang trọng 100% cotton hữu cơ Homemark 500GSM mềm mại và khả năng thấm hút cao, nhanh khô",Homemark,39000,Thổ Nhĩ Kì,Khăn,72000,33000,46
165206195,Hộp Nhựa 3 Tầng Đựng Bảo Quản Rau Củ Trong Tủ Lạnh ( Nhựa Cao Cấp ) - PaKaSa - Hàng Chính Hãng,PaKaSa,166600,Trung Quốc,Dụng cụ chứa đựng thực phẩm,242000,75400,31
272557098,"Hộp thủy tinh LocknLock BLANC bảo quản thực phẩm nhiều dung tích LLG110 - Hàng chính hãng, chịu nhiệt cao - JoyMall",Lock&Lock,67100,Trung Quốc,Dụng cụ chứa đựng thực phẩm,122000,54900,45
146287814,Keo bọt apollo foam (Có vòi kèm theo),Apollo,105000,Việt Nam,"Sơn, dầu mỡ, hóa chất",105000,0,0
275426511,Nhiệt Kế Đo Nhiệt Độ Sữa và Đồ Ăn Cho Bé - Hàng chính hãng,Gro-Fa,59000,Trung Quốc,Phụ kiện nhà bếp,59000,0,0
116459948,"Túi Đựng Hộp Cơm Giữ Nhiệt Grepaco Đựng Đồ Thức Ăn Nóng Lạnh Công Sở Văn Phòng Nam Nữ, Du Lịch  – Vải Bố Canvas, Kích Thước Lớn (Size To), Kiểu Giỏ Xách Có Khóa Kéo - Tặng Túi Đựng Muỗng Nĩa",GREPACO,69000,Việt Nam,Phụ kiện nhà bếp,69000,0,0
188447920,Thảm Lau Chân TCS SHOUSE phòng khách phòng tắm ngủ đế chống trơn trượt siêu thấm hút nước cao cấp sang trọng,Shouse,29000,Nhật Bản / Trung Quốc,Phụ kiện nhà tắm,29000,0,0
198198108,"Móc Áo Chrome Thông Minh 5 trong 1 ECODEALS - Cứng cáp, chắc chắn, tiết kiệm 80% không gian",ECODEALS,112000,Đài Loan,Phụ kiện giặt ủi,135000,23000,17
242084744,Đèn Pin Laze miDoctor Cao Cấp SD Lazer / Laser 303 Full Hộp - Chính Hãng,miDoctor,110000,Trung Quốc,,115000,5000,4
112321653,Thảm lau chân nhà tắm siêu thấm cao cấp chất liệu sợi lông cừu dày mềm mại - Hàng nhập khẩu,YORN,89000,Trung Quốc,Phụ kiện nhà tắm,89000,0,0
48724848,Elixir 16027 - Dây Đàn Acoustic Guitar Cỡ 11 (.011-.052) Phosphor Bronze Strings Custom Light - Hãng phân phối chính thức (Bộ Dây Ghi-ta phủ lớp Nanoweb cao cấp) - Kèm Móng Gảy DreamMaker,Elixir,389000,Mỹ,Phụ kiện đàn,389000,0,0
110382264,Bộ ga gối cotton lụa 60s Lidaco cao cấp (Nhiều mẫu lựa chọn),LIDACO,690000,Việt Nam,,690000,0,0
275496608,"Móc Dán Tường Siêu Dính Chịu Lực Inox 304, Móc Dính Tường Treo Đồ Quần Áo Đồ Dùng Đa Năng Tiện Ích",fofaHome,2000,Trung Quốc,Phụ kiện giặt ủi,3000,1000,33
117221062,Nắp giấy - Lốc 25 nắp trơn,New Star Paper,13500,Việt Nam,Phụ kiện nhà bếp,13500,0,0
46289932,Chảo chống dính Rainy sâu lòng từ 22cm đến 44cm,Rainy,107950,Việt Nam,Nồi và chảo,127000,19050,15
274917774,Chốt chặn cửa chống va đập 2 chiều inox 304 Hobby home decor CCD2 gió mạnh,Hobby Home Decor,155000,Trung Quốc,Bảo vệ nhà cửa,155000,0,0
130769103,"Bộ 12 Hũ Thủy Tinh Sọc Làm Sữa Chua 100ml, Hũ Lọ Yaourt, Lọ Pudding, Hủ Làm Sữa Chua, Caramen- Có Nắp Đậy- Hàng Chính Hãng MINIIN",MINIIN,56000,Việt Nam,Dụng cụ chứa đựng thực phẩm,65000,9000,14
72881357,Hộp Tăm Bông Lấy Ráy Tai 1000 cái,OEM,75000,Trung Quốc,Thiết bị phòng tắm,85000,10000,12
106693762,Dép Lỗ Đi Nhà Tắm Dành Cho Bé / Dép Đi Trong Nhà Vệ Sinh Nhanh Khô Cho Trẻ Em Cao Cấp,CHIKIGON,120000,China,Phụ kiện nhà tắm,120000,0,0
200919429,Bàn Học Bàn Làm Việc Black Karlma Chính Hãng IGA,IGA,255000,Việt Nam,"Nội thất phòng học, làm việc",255000,0,0
197725714,"Ghế Văn Phòng Công Thái Học Ergonomic TANNI Premium 03, Ghế Xoay Văn Phòng Làm Việc Cao Cấp Nhập Khẩu",OEM,1149000,Đài Loan,"Nội thất phòng học, làm việc",2300000,1151000,50
274526249,Ô Dù Chống Nắng Che Mưa Cản UV Tự Động Đóng Mở GROFA - Hàng chính hãng ( Giao màu ngẫu nhiên) ,Gro-Fa,114000,Việt Nam,,114000,0,0
270660646,Bình giữ nhiệt Daily Essential LocknLock LHC4325- kèm ống hút và cọ vệ sinh - 870ml,LocknLock,317000,Trung Quốc,Bình/ Ly giữ nhiệt,599000,282000,47
253629722,Ổ cắm Điện Quang ECO 4SBW (4 lỗ 4 công tắc),Điện Quang,107000,Việt Nam,"Ổ cắm, ổn áp, biến áp",141480,34480,24
275892617,"Khăn giấy treo tường 1280 tờ/4 lớp Topgia dạng rút tiện lợi cao cấp, tiết kiệm, an toàn kèm móc treo (Thùng 4 gói) 157x175cm",KINGO,155000,Việt Nam,Phụ kiện phòng ăn,199000,44000,22
273596597,Dụng cụ nạo gọt rau củ quả 3 trong 1 Elmich EL8415 - Hàng Chính Hãng,Elmich,47500,Trung Quốc,"Dao, kéo và phụ kiện",75000,27500,37
275551863,"Đệm trải sàn, Nệm văn phòng, Nệm, Topper hàng xuất nhật gấp gọn đa năng đủ size- Hàng chính hãng - Ghi 1m2*2m",Anh Lam Store,315000,Việt Nam,Nệm và phụ kiện,315000,0,0
6731165,Đèn Bàn Bảo Vệ Thị Lực Điện Quang ĐQ DKL14,Điện Quang,291000,Việt Nam,Đèn học và đọc sách,420407,129407,31
263697276,"Máy Bắn Vít Cầm Tay Không Dây FIVO, Linh Động 2 Kiểu Dáng, Tặng Kèm Dây Sạc Và 2 Đầu Vít, Nhỏ Gọn Tiện Dụng",FIVO,142000,Việt Nam,Các loại máy và phụ kiện,205000,63000,31
167062727,Kéo Cắt Thịt Gà SK5 Nhật Bản - Hàng Chính Hãng,PEAFLO,55000,Trung Quốc/Hàn Quốc/Mỹ/Thái Lan/Nhật Bản (tùy vào đợt hàng),"Dao, kéo và phụ kiện",65000,10000,15
270731260,"Túi Đựng Hộp Cơm , Túi Chứa Sữa Giữ Nhiệt  Cao Cấp Chống Thấm Nước AZ991",Azuno,50000,Việt Nam,Phụ kiện nhà bếp,50000,0,0
263029196,Bình Gas Bơm Bật Lửa Blue Star Chuyên Dụng Tặng Kèm 5 Đầu Bơm - Loại 150g,OEM,59000,China,"Bếp nướng, vỉ nướng",59000,0,0
62668670,Nệm Đa Năng K-Bedding,K-Bedding,1473450,Việt Nam,Nệm và phụ kiện,2200000,726550,33
73785488,"Bộ 3 nồi inox 4 đáy Nagakawa NAG1306 (16cm, 20cm, 24cm) - Quai mạ vàng - Dùng trên mọi loại bếp - Hàng Chính Hãng",Nagakawa,480000,Trung Quốc,Nồi và chảo,1000000,520000,52
275376419,"Đèn học chống cận chống cận, đèn đọc sách để bàn sạc pin 3 chế độ ánh sáng, màn hình LED hiện thị ngày - Hàng chính hãng",Anh Lam Store,250000,Trung Quốc / Singapore / Việt Nam,Đèn học và đọc sách,350000,100000,29
28324641,Bình Nước Handle Bottle 1.4L-PP-VN-15 HAP817PIK,LocknLock,46200,Việt Nam,,83000,36800,44
66672429,"Bộ 2 móc dán tường treo chổi, cây lau nhà, móc treo tường tiện lợi, Giao màu ngẫu nhiên",OEM,20000,Việt Nam,,20000,0,0
273294662,Tay Nắm Cửa INOX Dán Không Cần Khoan,NAVIVU,40000,Trung Quốc,Dụng cụ sửa chữa nhà cửa,40000,0,0
275478064,"Bình xịt sơn chống thấm chống dột Loại To Thương Hiệu Đức, Chống Thấm Dột Trần Nhà Mái hiên, Mái tôn, Trần Nhà - Hàng chính hãng",Aspor,69000,Đài Loan,"Sơn, dầu mỡ, hóa chất",130000,61000,47
171257570,"NỆM TRẢI SÀN FUKOJI,TOPPER NỆM,NỆM VĂN PHÒNG [HÀNG CAO CẤP] KÍCH THƯỚC 1M/1M4/1M6X2M",FUKOJI,384000,Việt Nam,Nệm và phụ kiện,500000,116000,23
162473896,Hột quẹt bật lửa Khò Gas Cầm Tay Mini Model AT600 Có Chỉnh Nhiệt Độ,OEM,99000,Trung Quốc,"Bếp nướng, vỉ nướng",99000,0,0
53972329,"Ghế xếp thư giãn cao cấp SUMIKA 179 - Khóa bằng kim loại, vải lưới Textilene thoáng khí, tải trọng 300kg, có khay đựng ly, dụng cụ tiện lợi, khung ghế bằng thép không gỉ, đế chống trượt",Sumika,960000,Trung Quốc,Nội thất phòng ngủ,1300000,340000,26
195951151,"Máy Xay Tỏi Ớt Bằng Pin Sạc VinBuy Tiện Lợi, Xay Đồ Đa Năng Xay Đồ Ăn Dặm Cho Bé Với 3 Lưỡi Dao Thép Không Gỉ, Dung Tích 100ml, 250ml – Hàng Chính Hãng",VinBuy,200000,China / Vietnam,Phụ kiện nhà bếp,200000,0,0
85029619,Ổ cắm Điện Quang ECO ĐQ ESK 43ECO (4 Lỗ 3 chấu),Điện Quang,116000,,"Ổ cắm, ổn áp, biến áp",142150,26150,18
216409332,Chảo Master Deep LocknLock + nắp 24cm LMD1245-VN-4-AL,LocknLock,644000,Việt Nam,Nồi và chảo,1474000,830000,56
199693007,Bình giữ nhiệt thể thao inox 304 Elmich EL-8292 dung tích 700ml,Elmich,240350,Trung Quốc,Bình/ Ly giữ nhiệt,615000,374650,61
275847793,Chăn chần bông K-bedding by Everon KMP chất vải Microfiber nhiều kích thước,K-Bedding,338000,Việt Nam,"Chăn, mền và phụ kiện",550000,212000,39
255352689,Ergonomic Footrest Ghế gác chân công thái học thương hiệu IGA - GN62,IGA,262000,Việt Nam,"Nội thất phòng học, làm việc",262000,0,0
184913941,"Bộ Vòi Tưới Cây , Rửa Xe 12m Kèm Vòi Tưới 6 Chế Độ - Hàng Nhập Khẩu",PEAFLO,440000,HK/TQ,Dụng cụ làm vườn,550000,110000,20
7114709,Đèn Pin Đội Đầu Sunhouse Cỡ Nhỏ She 5012,Sunhouse,70000,Việt Nam,,99000,29000,29
16214455,Bộ Quần Áo Mưa Vải Dù Size XXL Chống Thấm Cao Cấp,OEM,117325,,"Áo mưa, ô dù và phụ kiện đi mưa",130000,12675,10
71178441,"Áo Mưa Bít Dù Trơn, Áo Mưa Kín Người Vải Dù Siêu Dày, Chống Thấm Hiệu Quả, Phù Hợp Nam Và Nữ, Có Túi Đựng, Có Lựa Chọn Màu Sắc",XUDI,115000,Việt Nam,"Áo mưa, ô dù và phụ kiện đi mưa",115000,0,0
138460516,Ấm đun nước inox Happy Cook,Happy Cook,212000,Việt Nam,,307000,95000,31
173786359,"Bàn làm việc,bàn học,chữ u 50*100cm 60*120cm",HG FURNITURE H i G,520000,Việt Nam,"Nội thất phòng học, làm việc",520000,0,0
22081865,TÚI ÁO BÌNH GIỮ NHIỆT TIỆN LỢI,OEM,40000,Trung Quốc,Phụ kiện nhà bếp,40000,0,0
122692850,"Cây chà sàn thông minh cao cấp, chổi chà sàn đa năng 2 trong 1, cọ sàn và gạt nước – Parroti Easy ES02",Parroti,113050,Trung Quốc,Dụng cụ vệ sinh,119000,5950,5
275717951,Vòi sen tăng áp bát lớn xoay 360 độ 206780,TLG Thành Long,95600,China / Vietnam,Thiết bị phòng tắm,95600,0,0
275540651,"Thuốc Diệt Chuột Greenhome, Storm, Sinh Học Thế Hệ Mới, Tận Gốc, Cả Tổ, An Toàn Với Người, Vật Nuôi",Greenhome,13400,Đức,"Dụng cụ diệt chuột, côn trùng",20000,6600,33
205894291,"Miếng lót kê chân bàn ghế, giường, tủ - Lót chân ghế chống trầy, chống rung lắc - Hàng chính hãng",FuNu,27000,Trung Quốc,Bảo vệ nhà cửa,29000,2000,7
272390856,Bình giữ nhiệt Tiger MCY-K035 - HÀNG CHÍNH HÃNG,Tiger,278350,Việt Nam,Bình/ Ly giữ nhiệt,293000,14650,5
274608037,Đèn Pin Mini Siêu Sáng Cao Cấp Có Zoom ( 3 Chế Độ) - Hàng Chính Hãng,PaKaSa,49000,Trung Quốc,,98000,49000,50
89473437,Keo chống thấm vá vết nứt tường siêu chắc đa năng - keo trám tường thông minh,OEM,48900,Việt Nam,Dụng cụ sửa chữa nhà cửa,48900,0,0
275910217,"Áo Mưa Cánh Dơi Có Kiếng Đèn, Áo Mưa Kiếng Đèn Vải Dù Loại Siêu Dày, Hàng Việt Nam, Khổ To Rộng, Chống Thấm Hiệu Quả, Phù Hợp Nam Và Nữ, Có Túi Đựng, Có Lựa Chọn Màu Sắc",LuckyJQR,176400,Việt Nam,"Áo mưa, ô dù và phụ kiện đi mưa",180000,3600,2
76046302,Móc treo quần áo gắn sau cửa nice day 6 chấu Hobby home decor MTGC,Hobby Home Decor,55000,Trung Quốc,,55000,0,0
190510341,"Găng tay làm vườn, có móng vuốt, độ bền cao, chống thấm nước, đào, xới đất, dễ vệ sinh |Greenhome",Greenhome,29900,Việt Nam,Dụng cụ làm vườn,50000,20100,40
526529,Ổ Khóa Chống Cắt KINBar B1-60H,Kinbar,208050,Trung Quốc,Bảo vệ nhà cửa,219000,10950,5
167441583,Giá Treo Khăn Nhà Tắm Dán Tường - Giá Treo Khăn Nhà Bếp - Giá Treo Giày Dép Dán Cửa - Giao Màu Ngẫu Nhiên - HÀNG CHÍNH HÃNG,ENCOVINA,58000,Trung Quốc,,100000,42000,42
89227279,"Giấy bạc dán tường nhà bếp chống thấm dầu, thấm nước tiện dụng, cách nhiệt",ZOOYOO,69000,Trung Quốc,Decal & giấy dán tường,69000,0,0
185852744,Kê chân công thái học Hyperwork HPW-FR01 - Hàng chính hãng,HyperWork,389000,Trung Quốc,"Nội thất phòng học, làm việc",389000,0,0
275205612,"Bộ công tắc,Timer hẹn giờ bật tắt thiết bị điện KG316 T-II 25A/220V 16 chương trình",HUNONIC,95000,China / Vietnam,Thiết bị điều khiển thông minh,95000,0,0
4621783,Kệ để giày dép inox  5 tầng 8800-giao màu ngẫu nhiên,OEM,83000,Trung Quốc,Nội thất phòng khách,116000,33000,28
198097413,Máy Xay Hạt Khô Tiêu Chuẩn Châu Âu Máy Xay Ngũ Cốc Mini Công Suất 300w Lưỡi Dao 6 Cánh Thân Máy Bằng Thép Không Gỉ - Hàng Loại 1 - Chính Hãng MINIIN,MINIIN,117800,Trung Quốc,Phụ kiện nhà bếp,149000,31200,21
272219020,Đèn bàn Sunhouse SHE-16LED-A6,Sunhouse,182000,Trung Quốc,Đèn học và đọc sách,300000,118000,39
138180649,"Áo nệm, bọc nệm topper 2 mặt có khóa kéo, kích thước 1mx2m, 1m4x2m, 1m6x2m, 1m8x2m, Dùng cho nệm dày 3-9cm",RioTex,139000,Việt Nam,,139000,0,0
251285237,"Vỏ gối Lụa Tencel 50x70 45x65 cm Sen Đá Home Bedding cao cấp trơn màu, áo, bao gối nằm 100% Lyocell 60s",Sen Đá Home & Bedding,165000,Việt Nam,"Gối, ruột gối, vỏ gối",200000,35000,18
31116735,Hộp 10 đôi Đũa gỗ Kim Giao (Dài 27cm) 100% tự nhiên - Món quà quý đến từ rừng Cúc Phương Ninh Bình,Vườn Đặc Sản,120000,Việt Nam,"Đũa, muỗng, nĩa",120000,0,0
273948539,Miếng Dán Tường Đi Dây Điện - Kẹp Cố Định Luồn Dây Điện,NAVIVU,25000,Trung Quốc,,25000,0,0
144505446,"[Gói 4 miếng] Cước Rửa Chén Siêu Mạnh Scotch Brite - Cọ rửa mọi vết bẩn cứng đầu, an toàn cho vỉ nướng, nồi inox, gang, thép",ScotchBrite,43000,Việt Nam,Phụ kiện nhà bếp,51000,8000,16
274635890,Dù xếp gọn chống UV Kachi - hàng chính hãng,Kachi,199000,Trung Quốc,,199000,0,0
225240034,Chảo nồi có nắp chống dính đa năng Tefal One Pick Pot Pan 3 trong 1 - 22cm - Hàng chính hãng,Tefal,462000,Pháp,Nồi và chảo,1159000,697000,60
275869541,Vỏ gối nằm K-Bedding KMP chất vải Microfiber kích thước 35x50cm và 40x60cm,K-Bedding,55000,Việt Nam,"Gối, ruột gối, vỏ gối",80000,25000,31
274121302,"Gối Nằm Cao Su Thuần Việt - Thiết Kế Lượn Sóng, Êm Ái, Giảm Đau Gáy Cổ",Nệm Thuần Việt,330000,Việt Nam,"Gối, ruột gối, vỏ gối",530000,200000,38
141472707,Keo dán chuột keo dính chuột keo bẫy chuột (Dài 1.2M),OEM,75000,Trung Quốc,"Dụng cụ diệt chuột, côn trùng",84000,9000,11
194182728,"Trừ cỏ không chọn lọc (khai hoang) trừ cỏ mần trầu, cỏ chỉ, cỏ cú...GUSSI BASTA 200SL chai 900ml - công ty BMC",BMC,63500,Việt Nam,"Hoa tươi, Cây cảnh & Hạt giống",63500,0,0
253426645,Thùng đựng gạo Lock&Lock Special 5L HPL700 - 10Kg HPL510 - ,LocknLock,189000,Trung Quốc,,315000,126000,40
118966833,Móc Treo Cây Lau Nhà Dán Tường Đa Năng  Chịu Lực Tốt - Parroti Keeper KP02,Parroti,20900,Trung Quốc,,20900,0,0
263239686,Pin kiềm AA Philips LR6P2B/97 vỉ 2 viên,Philips,19100,Trung Quốc,Pin và dụng cụ sạc pin,25000,5900,24
221515012,Vòi tắm hoa sen KG60 tăng áp lực nước công nghệ mới có hạt lọc nano với chất liệu inox304- Hàng chính hãng,KINGO,56000,Việt Nam,Thiết bị phòng tắm,95000,39000,41
134716239,"Tamper Nén Cà Phê | Size 51, 53, 58mm",NOX COFFEE TAKE AWAY,290000,China,,290000,0,0
275875277,"Hộp Đựng Khăn Giấy Chữ Nhật, Tròn Siêu Sang INOCHI chất lượng Nhật Bản - Tặng kèm khăn lau PaKaSa",Inochi,79000,Việt Nam,Phụ kiện phòng ăn,122000,43000,35
271511335, Bình cắm hoa mini Aderia - Tebineri - Màu hồng/Xanh Dương,Aderia,577520,Nhật Bản,Lọ hoa & hoa trang trí,691200,113680,16
54644755,"Áo bọc bàn để ủi quần áo, nhiều họa tiết - Áo trùm bàn ủi đồ, chọ size theo ý, giao mẫu ngẫu nhiên+ Tặng kèm hình dán",ST SOHOGO,59000,,Phụ kiện giặt ủi,59000,0,0
116270289,"Túi Đựng Hộp Cơm Grepaco Giữ Nhiệt Lạnh Nóng Công Sở Văn Phòng, Du Lịch Đựng Đồ Thức Ăn – Vải Bố Canvas, Kích Thước To (Size Lớn), Kiểu Dáng Giỏ Xách Thời Trang Nam Nữ - Tặng Túi Đựng Muỗng Nĩa",GREPACO,49000,Việt Nam,Phụ kiện nhà bếp,49000,0,0
275271264,Chế Phẩm Diệt Kiến Gián Sinh Học Anbio Sử Dụng An Toàn Chai 10 ml,smatayoko,36000,Việt Nam,"Dụng cụ diệt chuột, côn trùng",36000,0,0
167046966,Áo bọc bàn để ủi cầu là quần áo có mút Kokomega BU04 KT: 35*100cm( Và Sử Dụng Cho BU-120),KokOmega,72000,Việt Nam,Phụ kiện giặt ủi,79000,7000,9
275339706,Hạt giống hoa cúc ngũ sắc Zinnia VTP73,An Phát ,11752,Italy,"Hoa tươi, Cây cảnh & Hạt giống",11752,0,0
79448043,Hạt giống dưa hấu Sugar Baby VTS132,Sen Vàng Seeds,13000,Mỹ,"Hoa tươi, Cây cảnh & Hạt giống",13000,0,0
189491905,"Nhang Sen Thuần Khiết Liên Tâm 20.5cm 160 cây - Ít khói, dịu nhẹ, 100% Đài sen thiên nhiên",Liên Tâm,66250,Việt Nam,,75000,8750,12
114538869,"Kệ gỗ treo tường loại mảnh, kệ trang trí Anzzar nhiều kích thước trang trí phòng khách, phòng ngủ",anzzar,60000,Việt Nam,Nội thất phòng khách,60000,0,0
271332358,Chảo sâu lòng chống dính đáy từ Tefal So Matcha - 20cm,Tefal,299200,Pháp,Nồi và chảo,449000,149800,33
47115292,"Đèn led đom đóm fairy light dây đồng trang trí decor phòng, cắm trại tạo không gian cổ tích lãng mạn",OEM,65000,Trung Quốc,,65000,0,0
105026602,"Chuông báo động, còi báo động dành cho người lớn tuổi, người bệnh ",VIMOS,229080,Đài Loan,Bảo vệ nhà cửa,249000,19920,8
275688061,Cây Thông Cống Móc Rác Móc Tóc,NAVIVU,15000,Trung Quốc,Dụng cụ vệ sinh,15000,0,0
222605996,"Kệ Inox Gác Bồn Rửa Chén Pimisi PRR-11 Với Tay Cầm Bằng Nhựa Và Khay Inox 304 Thiết Kế Hình Chữ Nhật, Góc Vuông Được Bo Tròn Và Rổ Kéo Điều Chỉnh Độ Dài Co Giản Để Úp Bát Đĩa - Rau Củ Quả Phù Hợp Với Nhiều Chậu Rửa Bát Trong Nhà Bếp | Hàng Chính Hãng",Pimisi,78000,Việt Nam,,140000,62000,44
95875948,Ổ khóa cửa treo Việt Tiệp đồng vàng,Việt Tiệp,54144,Việt Nam,Bảo vệ nhà cửa,54144,0,0
191326374,"Bộ Sạc Pin AA, AAA Beston Tự ngắt khi đầy Sạc Tốc Độ Cao Có Led báo trạng thái sạc BST-C9009, Pin sạc chính hãng",BESTON,60000,Trung Quốc,Pin và dụng cụ sạc pin,60000,0,0
275922636,Máy tạo khói cho thác nước phong thuỷ,OEM,125000,"Anh, Việt Nam",Vật phẩm phong thủy,125000,0,0
192733182,Nến điện | JYSK Klaus | paraffin/thủy tinh | xám | DK8xH10/15cm,JYSK,189000,Trung Quốc,Trang trí nhà cửa khác,199000,10000,5
274755455,Móc treo đồ hình chữ S chịu lực Chất liệu inox không gỉ Siêu cứng Chịu lực Chắc chắn Nhiều kích thước Sx tại Việt Nam,Fresh Friend,2000,Việt Nam,,2000,0,0
175839151,"Miếng cước cọ rửa siêu sạch có mút Scotch-Brite 3M CR-SSG1 - Rửa chén siêu nhanh, hàng nhập từ Thái Lan, Lấy sạch vết bẩn cứng đầu",3M,13000,Mỹ,Phụ kiện nhà bếp,15000,2000,13
41548705,Set 3 túi đựng chăn màn quần áo chống thấm - màu ngẫu nhiên,OEM,88000,Trung Quốc,Phụ kiện phòng ngủ,97999,9999,10
275406980,Đá bọt biển chà gót chân tẩy tế bào chết 4 in 1,Nhà của Mẹ,39000,China / Vietnam,Phụ kiện nhà tắm,39000,0,0
103475918,HỘP ĐỰNG TRỨNG 24 QUẢ TRONG SUỐT 1 TẦNG NHỰA VN KHAY TRỨNG 24 Ô,OEM,23000,Việt Nam,Dụng cụ chứa đựng thực phẩm,47000,24000,51
271138307,"Bảng LED quảng cáo siêu mỏng mặt kính cường lực, menu LED siêu mỏng",Nhà 101,260000,Việt Nam,Tranh trang trí,480000,220000,46
248259114,"Túi bọc kín quần áo chống bụi chống ẩm mốc treo tủ PEVA, có khóa tiện lợi sắp xếp gọn tủ quần áo GD695-BAKhoa",So Easy,19000,Việt Nam,Phụ kiện phòng ngủ,19000,0,0
129285573,Bộ Dụng Cụ Đa Năng Nâng Và Di Chuyển Đồ Đạc Trong Nhà Thông Minh Nhẹ Nhàng Nhanh Chóng- Hàng Chính Hãng MINIIN,MINIIN,89000,China / Vietnam,,89000,0,0
98885562,Combo 5 Bộ Bóng Đèn Led Tuýp 1m2 MPE T8 Ánh Sáng Trắng 6500K,MPE,450000,Việt Nam,Bóng và linh kiện đèn,450000,0,0
98182315,"Hạt Giống Hoa Cúc Đại Đóa Nhiều Màu RD 801- NON GMO- Hạt giống Rạng Đông, Chất lượng vượt trội !",Rạng Đông,9000,Việt Nam,"Hoa tươi, Cây cảnh & Hạt giống",9500,500,5
274189557,Bình Nước Eco Bottle Gen II 310ml Tupperware chính hãng,Tupperware,240000,Ấn Độ/Indonesia,,240000,0,0
275246637,"Nệm Trải Sàn, Đệm, Topper Hàng Xuất Nhật 1Mx2M, 1M2X2M, 1M4x2M, 1M6x2M, 1M8X2M Dày 9CM Tặng Kèm Drap Nệm",FUKOJI,498000,Việt Nam,Nệm và phụ kiện,700000,202000,29
208779349,Vợt Muỗi kiêm Đèn Bắt Muỗi 2 trong 1 - Weidasi WD-955,WEIDASI,200000,Trung Quốc,"Dụng cụ diệt chuột, côn trùng",200000,0,0
696891,Bộ Dây Đàn Guitar Classic Alice AC130,Alice,69000,Trung Quốc,Phụ kiện đàn,69000,0,0
149376396,"Túi peva SmileBox size lớn bọc nhiều bộ quần áo treo tủ chống thấm, chống bụi, có khóa kéo đôi tiện lợi nhiều size ngắn dài 90cm 110cm- Hàng chính hãng",SmileBox,105000,Trung Quốc,Nội thất phòng ngủ,105000,0,0
272365565,Bình giữ nhiệt Tiger MCY-K060 - HÀNG CHÍNH HÃNG,Tiger,325000,Việt Nam,Bình/ Ly giữ nhiệt,325000,0,0
108956568,"Áo mưa trẻ em cao cấp, Áo mưa cho bé học mẫu giáo trở lên_không mùi, an toàn cho trẻ nhỏ",Quang Long,129000,Việt Nam,"Áo mưa, ô dù và phụ kiện đi mưa",129000,0,0
6864843,Phân bón kích thích ra hoa đậu trái Kina npk 6-30-30 + TE (hũ 500g),Kiên Nam,82160,Thái Lan,"Hoa tươi, Cây cảnh & Hạt giống",82160,0,0
35760336,Áo bọc bảo vệ nệm 2 mặt Có Dây Kéo NAB 16200 (200 x 160 x 15 cm) Màu ngẫu nhiên,Happy,115000,Việt Nam,,115000,0,0
274067235,"Combo 25 hộp giấy kraft thực phẩm, hộp giấy nắp gập màu nâu đựng thức ăn, hộp giấy nắp gài gói đồ ăn mang đi",MAGIX,55000,Việt Nam,Dụng cụ chứa đựng thực phẩm,55000,0,0
275205954,"Khay đựng đồ dùng dán tường phòng tắm nhà bếp, nhựa Việt Nhật chính hãng - HÀNG VIỆT NAM",Việt Nhật,39000,Việt Nam,,60000,21000,35
217385565,"Lọ hoa thủy tinh mini LH045, bình hoa thủy tinh trồng cây thủy sinh",AV CRYSTAN,19000,Việt Nam,Lọ hoa & hoa trang trí,19000,0,0
273691951,Chậu trồng hoa thông minh chân cao 60cm,DAIM,232650,Việt Nam,"Hoa tươi, Cây cảnh & Hạt giống",232650,0,0
270501653,Đế Lót Chậu Cây Có Bánh Xe Dùng Để Chậu Cây Chậu Hoa Ngoài Trời Hoặc Trong Văn Phòng Giúp Không Gian Gọn Gàng Sạch Sẽ - Đế Vuông Màu Vàng Cạnh 30Cm Gỗ Tràm Bền Bỉ Thương Hiệu ANKAN,ANKAN,75000,Việt Nam,Ngoại thất sân vườn,139000,64000,46
271064572,Bình nước Detox Moriitalia 67972002,Moriitalia,251000,Trung Quốc,,527000,276000,52
275220090,Giỏ Đựng Đồ Thông Minh Gấp Gọn Việt Nhật Tặng Kèm Móc Dính Treo - Hàng Việt Nam,Việt Nhật,89000,Việt Nam,Phụ kiện giặt ủi,178000,89000,50
275729000,Kệ kê chậu cây Dài 80 -90 cm. Rộng 20-25-30cm. Cao 10-15-20-25-30cm. Hộp thép 16 x16mm. 2 nan phụ ( Hàng Chính Hãng ),XM,200000,Việt Nam,Ngoại thất sân vườn,200000,0,0
275008437,"Bình đun giữ nhiệt Locknlock Heating tumbler EJC723IVY - 220-240V, 50-60Hz, 300W - Dung tích 300ml",LocknLock,819000,Trung Quốc,Bình/ Ly giữ nhiệt,1580000,761000,48
195111061,Chảo chống dính Inox đáy từ nguyên khối đáy liên Elmich Trimax Classic EL-2702OL size 24cm,Elmich,357200,Việt Nam,Nồi và chảo,820000,462800,56
273169094,"Hộp cơm điện văn phòng cầm tay Bear DFH-B20S6, 3 khay đựng thức ăn, hấp/ đun sôi/ hâm nóng - HÀNG CHÍNH HÃNG",Bear,558600,Trung Quốc,Bộ hộp cơm và phụ kiện,790000,231400,29
275008440,Bình giữ nhiệt Vacuum coffee tumbler LocknLock LHC3329BEG - Dung tích 460ml,LocknLock,262000,Trung Quốc,Bình/ Ly giữ nhiệt,499000,237000,47
251462367,"Bình Nước Giữ Nhiệt Mini Lõi Inox 304 300ml, Ly Giữ Nhiệt 5 Lớp Cách Nhiệt Cao Cấp Giữ Nhiệt Lên Đến 12 Giờ - HÀNG CHÍNH HÃNG MINIIN",MINIIN,86000,Trung Quốc,Bình/ Ly giữ nhiệt,99000,13000,13
273347199,"Hộp Đựng Thực Phẩm Tủ Lạnh, Đồ Ăn Bằng Inox 304 Có Nắp Nhựa Kèm Theo Tiện Lợi (135x105x58 mm) Và Loại To ( 250x200x60 mm)",TOK DO DO TOKDODO TOK DO DO,14000,China / Vietnam,Dụng cụ chứa đựng thực phẩm,14000,0,0
253047582,Thanh Xốp Chắn Khe Cửa Tiện Lợi Và Chống Côn Trùng Chắn Gió Điều Hòa,fofaHome,10000,Việt Nam,Bảo vệ nhà cửa,14500,4500,31
128133958,Đèn Bắt Muỗi Quạt Hút Thông Minh 2021 RẠNG ĐÔNG - Không Tiếng Nổ - Nhựa ABS Siêu Bền - HÀNG CHÍNH HÃNG,Rạng Đông,295000,Việt Nam,,295000,0,0
138534630,"Tủ nhựa KATA 5 tầng giá rẻ, chất lượng, chính hãng, nhiều màu sắc",Duy Tân,999000,Việt Nam,Nội thất phòng ngủ,1200000,201000,17
20346270,Nồi áp suất inox 304 Elmich 20cm EL3369 (4L) - Hàng Chính Hãng,Elmich,981000,Trung Quốc,Nồi và chảo,1550000,569000,37
15343778,Kệ góc để đồ nhà tắm dán tường inox 304 bóng Hobby Home Decor KG1,Hobby Home Decor,165000,Trung Quốc,,279000,114000,41
7776823,Hộp Quẹt Bật Lửa Khò 1 Tia,OEM,39000,,"Bếp nướng, vỉ nướng",39000,0,0
275242547,Combo 10 móc treo đồ dán tường,OEM,45000,Trung Quốc,,45000,0,0
272032663,"Bàn Để Ủi, Cầu Là Quần Áo ERNEST Dạng Đứng Gấp Gọn, Vỏ Cách Nhiệt, Tích Hợp Vị Trí Ủi Tay Áo,7 Cấp Độ Nâng, Màu Đen Sang Trọng Kích Thước 129x35,5x82 CM  | Index Living Mall | Nhập Khẩu Thái Lan - Phân Phối Độc Quyền Tại Việt Nam",Index Living Mall,1440000,Thái Lan,Phụ kiện giặt ủi,1490000,50000,3
51373821,Đèn bàn học led cảm ứng chính hãng Rạng Đông Model: RD RL 36 LED,Rạng Đông,229000,Việt Nam,Đèn học và đọc sách,229000,0,0
112760341,"Thùng rác treo tủ bếp có nắp đậy thông minh, thùng rác treo tường dán tường, có thanh trượt cửa bếp – Parroti Bin BN02",Parroti,151050,Trung Quốc,Dụng cụ vệ sinh,159000,7950,5
273660940,Dụng cụ ép tỏi Elmich EL8413 - Hàng Chính Hãng,Elmich,55000,Trung Quốc,Phụ kiện nhà bếp,95000,40000,42
273220233,"Chảo chống dính siêu bền Elmich EL-5942BE Size 20, 24, 26 và 28cm - Hàng Chính Hãng",Elmich,246050,Việt Nam,Nồi và chảo,369000,122950,33
275072027,"Rèm cửa DULCETT dán tường chống nắng, rèm cửa dán trang trí cửa sổ - phòng khách dễ dàng lắp đặt không khoan đục rèm cửa sổ dán",DULCETT,52000,Trung Quốc,Nội thất phòng khách,80000,28000,35
138488520,"Đệm Tròn Ngồi Bệt , Đệm Lót Ghế Xinh Xắn  Phong Cách Nhật Bản Kích Cỡ 45x5cm - Hàng Loại 1 Chính Hãng MINIIN",MINIIN,103550,Việt Nam,Nội thất phòng khách,109000,5450,5
120166109,"Bóng Philips LED bulb Essential E27 (5W,7W,9W,11W,13W) - E27 (3000K/6500K)",Philips,38500,Trung Quốc,Bóng và linh kiện đèn,66000,27500,42
53830678,"1 cặp ruột gối hơi cao cấp - Gòn bông nhân tạo an toàn sức khỏe, không chứa chất độc hại - Có khóa kéo dễ dàng thêm bớt gòn bên trong - Êm ái, mềm mịn",A,58000,Việt Nam,"Gối, ruột gối, vỏ gối",65000,7000,11
7699064,"Chảo Nhôm Sâu Lòng Chống Dính Lock&Lock Baum Marble 1 Tay Cầm, Nắp Thủy Tinh LBU1285 (28cm)",LocknLock,384000,Trung Quốc,Nồi và chảo,776000,392000,51
251520028,Giá Treo Quần Áo Túi Xách - Kệ Để Đồ Dày Dép Phong Cách Hàn- Màu Gỗ Tự Nhiên,GACCO,740000,Việt Nam,Nội thất phòng ngủ,740000,0,0
76451291,Đèn Led Đom Đóm Dây Kẽm Dễ Uốn Kèm Pin CR2032,OEM,20000,Việt Nam,,20000,0,0
272409524,Bình giữ nhiệt gia đình inox 304 Elmich EL8298 dung tích 900ml - Hàng chính hãng,Elmich,295450,Trung Quốc,Bình/ Ly giữ nhiệt,550000,254550,46
181361773,"Bàn học gấp gọn, bàn laptop đa năng tùy chỉnh được góc nghiêng giảm đau lưng mỏi mắt - GM55",IGA,199000,Việt Nam,"Nội thất phòng học, làm việc",199000,0,0
215896319,"Băng Keo Vá Ống Nước Silicon Chịu Nhiệt Nóng Lạnh, Chống Thấm Nước",NAVIVU,36000,Trung Quốc,Dụng cụ sửa chữa nhà cửa,36000,0,0
270462666,Ly nhựa 2 lớp Daily Essential LocknLock HAP526 - Ống hút cùng màu - Nắp đậy trong suốt - Kèm cọ vệ sinh - Dung tích 770ml,LocknLock,108000,Trung Quốc,"Bình, ly uống trà và phụ kiện",217000,109000,50
78941957,Kệ Sách . Kệ Trang Trí Tổ Ong  Đa Tầng Convent 234F - GP100,HAJI OFFICIAL,124000,Việt Nam,"Nội thất phòng học, làm việc",205000,81000,40
185653590,Chăn hè cotton chần bông LIDACO Home nhiều mẫu lựa chọn khổ rộng 2mx2m3,LIDACO,165000,Việt Nam / Trung Quốc,"Chăn, mền và phụ kiện",250000,85000,34
203467650,"[COMBO MUA 10 TẶNG 2] Bóng Đèn OPPLE LED Bulb Ecomax E27 P45-E27-3W- Tiết Kiệm Điện, Tuổi Thọ Cao Lên Đến 20.000 Giờ",Opple,188500,Trung Quốc,Bóng và linh kiện đèn,290000,101500,35
177530727,Bộ Kim Chỉ May Vá Quần Áo Xách Tay Mini 58 Món Tiện Lợi Kèm Bao Da Cao Cấp-Hàng Chính Hãng,lilahome,98000,Trung Quốc,Phụ kiện phòng ngủ,119000,21000,18
202519681,Đồng Hồ Báo Thức Để Bàn Có Đèn Đêm Deli - Thân Nhựa Kim Thiếc Cao Cấp Kiểu Dáng Tinh Tế - Có Nút Bấm Báo Lại Báo Thức,Deli,169000,Trung Quốc,Đồng hồ,304200,135200,44
275044260,Tấm trải tiện ích Everon Lite (Giao màu ngẫu nhiên),Everon Lite,322000,Việt Nam,Nệm và phụ kiện,395000,73000,18
141971329,"Túi Đựng Hộp Cơm Grepaco Giữ Nhiệt Nóng Lạnh Dạng Đứng Có Ngăn Phụ Đựng Đồ Thức Ăn Văn Phòng, Du Lịch – Vải Bố Canvas, Kích Thước Size Vừa, Kiểu Giỏ Xách Thời Trang Nam Nữ - Tặng Túi Đựng Muỗng Nĩa - Hàng Chính Hãng",GREPACO,69000,Việt Nam,Phụ kiện nhà bếp,69000,0,0
89308771,Thước Dây Deli Có Thể Làm Móc Chìa Khóa- Dài 1.5M - Thước Dây Cuộn - Màu Trơn Xanh Lá / Xanh Dương / Hồng / Trắng  - 1 Chiếc,Deli,18000,Trung Quốc,Thiết bị đo lường,32400,14400,44
186557908,"Túi 100 Dây Rút, Lạt Nhựa (Trắng/Đen) Siêu Bền Để Làm Vườn, Thi Công Tiện Lợi",NAVIVU,19500,Trung Quốc,Dụng cụ sửa chữa nhà cửa,19500,0,0
177477840,GA CHỐNG THẤM KHÁNG KHUẨN DÀNH CHO NỆM 5-20CM KÍCH THƯỚC 1M/1M2/1M4/1M6/1M8/2M2,RioTex,140000,Việt Nam,,290000,150000,52
263239696,Pin kiềm AAA Philips LR03P10TS/97 vỉ 10 viên,Philips,85000,Trung Quốc,Pin và dụng cụ sạc pin,109000,24000,22
275407651,"Dụng cụ mở nắp chai, mở rượu vang, khui hộp nhanh chóng và tiện lợi inox bền đẹp rất được ưa chuộng tại Nhật Bản - PaKaSa",PaKaSa,29000,Trung Quốc/Hàn Quốc/Mỹ/Thái Lan/Nhật Bản (tùy vào đợt hàng),Phụ kiện nhà bếp,58000,29000,50
74859074,"Chuông Cửa Không Dây Thông Minh CTFAST CT - 01 (1 Nút Bấm, 1 Chuông ), Chống Nước, Khoảng Cách Sử Dụng Hiệu Quả 300 mét - Hàng Chính Hãng",CTFAST,145000,Việt Nam,Bảo vệ nhà cửa,145000,0,0
275511650,Túi hút chân không thực phẩm dạng cuộn Elmich EL0024D,Elmich,75100,Việt Nam,Dụng cụ chứa đựng thực phẩm,110000,34900,32
243047801,Gối tựa lưng văn phòng cao su non A kích thước 34 x 34 cm x 6/10cm,A,148000,Việt Nam,"Gối, ruột gối, vỏ gối",180000,32000,18
271079072,Cốc sứ La Fonte - 006415,La Fonte,32100,Trung Quốc,"Ly, cốc & phụ kiện ly",63000,30900,49
165758264,Bộ dao 2 chiếc Eco Family Sunhouse KS-KN2E1,Sunhouse,105000,Việt Nam,"Dao, kéo và phụ kiện",163000,58000,36
8917937,Phân bón gốc NPK đa năng Đầu Trâu - tốt cây nhiều hoa (túi 1kg),Bình Điền Mekong,50000,Việt Nam,"Hoa tươi, Cây cảnh & Hạt giống",50000,0,0
191136118,"Bóng Đèn Led Bulb, Led Edison Đui E27 Các Loại - Hàng Chính Hãng NAVIVU",NAVIVU,15000,Việt Nam,Bóng và linh kiện đèn,15000,0,0
274661878,"Túi đựng rác gia đình, Bao đựng rác văn phòng tiện lợi nhiều cỡ siêu dai , tự phân hủy sinh học bảo vệ môi trường - Hàng chính hãng PaKaSa ( Giao màu ngẫu nhiên)",PaKaSa,29000,Việt Nam,Dụng cụ vệ sinh,58000,29000,50
197878902,"Set 10 Móc Nhựa Tròn Dán Tường Nhiều Màu Sắc Hiện Đại, Móc Treo Đồ Trang Trí Nhà Cửa - Chính Hãng NAVIVU",NAVIVU,30000,Trung Quốc,,30000,0,0
20883988,Máy Sấy Giày Và Khử Mùi Tavana SG-002,Tavana,189000,Trung Quốc,Phụ kiện giặt ủi,189000,0,0
71744195,"Bộ Lau Nhà Xoay Tay Lock&Lock Dual Bucket Spin Mop  ETM478 ( thùng giặt , cây , 2 bông lau)",LocknLock,668000,Trung Quốc,Dụng cụ lau nhà,1200000,532000,44
190755062,"Hạt Giống Rau Má Greenhome, Gói 1g, Dễ Trồng Quanh Năm, Nảy Mầm Cao, Thu Hoạch Nhanh, Năng Suất Cao R12",SENVANG SEEDS,8722,Việt Nam,"Hoa tươi, Cây cảnh & Hạt giống",8900,178,2
179981677,Ly thủy tinh tay cầm nắp vặn Quattro 415ml - Bormioli Rocco - Italy,Bormioli Rocco,120000,Ý,"Ly, cốc & phụ kiện ly",139000,19000,14
172708377,Dụng Cụ Ép Nước Trái Cây Bằng Hợp Kim Nhôm -Máy Ép Các Loại Rau Củ - Hàng Loại 1 - Chính Hãng MINIIN,MINIIN,118750,Trung Quốc,Phụ kiện nhà bếp,142000,23250,16
197062243,"{Nhiều Sự Lựa Chọn} Lốc Móc Treo Quần Áo Đa Năng Hara Tùy Chọn Mẫu Phù Hợp Cho Các Loại Quần Áo : Áo Đầm , Áo Kiểu, Áo Mỏng , Quần Áo Người Lớn , Trẻ Em - Chính Hãng inochi ( Tặng khăn lau pakasa) Giao màu ngẫu nhiên",Inochi,59000,Việt Nam,Phụ kiện giặt ủi,91000,32000,35
14966268,Bình Xịt Phun Sương Tưới Cây - Bình Xịt Tưới Cây 400ML Tiện Dụng,OEM,35000,Việt Nam,Dụng cụ làm vườn,45000,10000,22
275578501,"Phân Bón Hoa Giấy Greenhome, Bao 700gr, Hữu Cơ, Giúp Thân Cứng Cáp, Tạo Tán, Ra Bông Nhiều, Lâu Tàn",Greenhome,18900,Việt Nam,"Hoa tươi, Cây cảnh & Hạt giống",36000,17100,48
273561523,"Găng tay hỗ trợ ủi đồ cho bàn là phổ thông, bàn là hơi nước. Giúp ủi những chỗ khó và chống bỏng tay. Tấm mút đeo tay ủi quần áo cho mọi bàn ủi. Bao bọc bàn tay ủi đồ. Hỗ trợ ủi đồ dạng đứng",SOHOGO,55000,Trung Quốc,Phụ kiện giặt ủi,55000,0,0
180026928,"Đồng Hồ Báo Thức Để Bàn Phong Cách Vintage, 2 Quả Chuông To - Hàng Chính Hãng",DORON,111888,Trung Quốc,Đồng hồ,111888,0,0
5739193,"Cân điện tử, cân tiểu ly bỏ túi",OEM,69000,Trung Quốc,Dụng cụ làm bánh,69000,0,0
275934763,"Nam Châm Gắn Cánh Tủ, Giữ Cánh Cửa Có Lực Hút Mạnh - Giữ Chốt Cánh Tủ Quần Áo, Ngăn Kéo, Tủ Bếp Tiện Lợi, Takyhome 3430",TakyHome,9900,Trung Quốc,Bảo vệ nhà cửa,9900,0,0
19911204,Hộp Nhựa Chia Thuốc 7 Ngày KOMONOYA -  Hàng Nội Địa Nhật Bản ,KOMONOYA,35340,,Phụ kiện phòng ngủ,35340,0,0
274823298,LỐC 20 MIẾNG KEO DÍNH CHUỘT LOẠI TỐT,Dudaco,77000,Việt Nam,"Dụng cụ diệt chuột, côn trùng",77000,0,0
6256843,Cân hành lý cầm tay 50kg - Cân điện tử cầm tay max 50kg,OEM,95000,,Dụng cụ làm bánh,95000,0,0
149349961,Nhang Xanh Phổ Thông 30cm 500g,Nhang Xanh,165000,Việt Nam,,165000,0,0
272303922,Bông Lau Sợi Microfiber Xoay 360 Độ Thay Thế Cho Cây Lau Nhà Damas G720,Damas,100000,Trung Quốc,Dụng cụ lau nhà,100000,0,0
210276349,"Đất Sét Nung Trồng Cây Greenhome, Bao 6lít, Thái Lan, Trồng Sen Đá, Phong Lan, Sứ, Thuỷ Canh, Chống Mọc Cỏ, Thoáng Khí",Greenhome,19900,Thái Lan,"Hoa tươi, Cây cảnh & Hạt giống",36000,16100,45
275351219,Thảm Lau Chân Phòng Khách Nhà Tắm Nhà Bếp Siêu Thấm Nước - Giao màu ngẫu nhiên,PEAFLO,51000,Thái Lan / Trung Quốc / Malaysia (Tùy từng đợt nhập hàng),Phụ kiện nhà tắm,65000,14000,22
275805092,"Hộp 40 Viên Pin Toshiba AA , AAA 1,5V Toshiba - hàng chính hãng",Toshiba,180000,Trung Quốc,Pin và dụng cụ sạc pin,240000,60000,25
37939943,Ủng Nhựa Bảo Hộ Safety Jogger Hercules S5,Safety Jogger,350000,,Bảo hộ lao động,350000,0,0
185973638,"Đế Chống Rung Lắc, Chống Ồn Máy Giặt - Chân Kê Dùng Cho Mọi Loại Máy Giặt, Bàn Ghế, Mát Lọc Nước",PEAFLO,39000,Hàn Quốc / Trung Quốc,Phụ kiện giặt ủi,45000,6000,13
275068463,Set 2 đai tắm cọ lưng silicon tặng kèm móc treo GROFA ,Gro-Fa,49000,Trung Quốc,Phụ kiện nhà tắm,49000,0,0
162427187,Dụng Cụ Bơm Hút Rượu Xăng Dầu Chất Lỏng Bóp Tay Tiện Lợi Đa Năng - Hàng Loại 1-  Chính Hãng MINIIN,MINIIN,47000,Trung Quốc,Phụ kiện nhà bếp,76000,29000,38
275257169,Dụng Cụ Thông Cống Có Quai Cầm Dây Dài 4M Tiện Dụng,Nhà của Mẹ,123500,China / Vietnam,Dụng cụ vệ sinh,130000,6500,5
117048535,Giấy lọc cà phê Hario 100 cái (V60-VCF-02-100M),Hario,104000,Nhật Bản,"Bình, ly uống cà phê và phụ kiện",109000,5000,5
273785674,Thớt Nhựa RECIEP Có Móc Treo | Index Living Mall | Nội Thất Nhập Khẩu Thái Lan - Phân Phối Độc Quyền Tại Việt Nam,Index Living Mall,69400,Thái Lan,Phụ kiện nhà bếp,149000,79600,53
275341580,"Tủ Nhựa Gấp Gọn Nubie Ngang 60/70/80cm Có Ngăn Treo Quần Áo, Đựng Đồ Dùng Size Lớn, Bánh Xe Xoay",Nubie,775000,Trung Quốc,Nội thất phòng ngủ,1499000,724000,48
76058957,"Kệ gia vị chữ E cao cấp VANDO bằng thép carbon chống gỉ, chống xước, kệ đựng chai lọ gia vị đa năng, kệ để đồ nhà bếp gọn gàng, sang trọng",VANDO,249000,Việt Nam,,427000,178000,42
273244363,"Kệ Sách Gỗ 5 Tầng, Giá Sách Đứng Cạnh Bàn Làm Việc - GP189",IGA,348000,Việt Nam,"Nội thất phòng học, làm việc",348000,0,0
37495650,"Kệ Sách Để Sàn Cao Cấp 11 Tầng Bằng Gỗ MDF Phủ Melamin Chống Nước, Chống Xước - Hàng Chính Hãng",IGA,439000,Việt Nam,"Nội thất phòng học, làm việc",439000,0,0
194497162,BÌNH GIỮ NHIỆT INOX 304 SUNHOUSE 900ML KS-TU900I,Sunhouse,145000,Việt Nam,Bình/ Ly giữ nhiệt,175000,30000,17
133870923,Tủ Vải Áo Quần Đa Năng- Tiết Kiệm Diện Tích- Khung Sắt Chắc Chắn Vải Chống Thấm- Hàng Chính Hãng MINIIN,MINIIN,200450,Việt Nam,Nội thất phòng ngủ,249000,48550,19
68187835,Bộ dụng cụ di chuyển đồ vật nặng trong nhà thông minh KIOTOOL tải trọng 600kg chuyên dụng di chuyển don nhà - Màu ngầu nhiên,KIOTOOL,285000,Trung Quốc,Dụng cụ sửa chữa nhà cửa,285000,0,0
197902584,Bóng đèn Led 50w 40w 30w 20w 15w 10w 5w bup trụ tiết kiệm điện thân kín chống mưa Posson LC-5-50x,Posson,14000,Việt Nam,Bóng và linh kiện đèn,19000,5000,26
274336213,"Bình trà thủy tinh KG85 2 lớp pha cách nhiệt tốt, có lõi lọc inox304 cao cấp dung tích 500ml - Hàng chính hãng",KINGO,89000,Taiwan,Bình/ Ly giữ nhiệt,129000,40000,31
198458831,Chảo Inox liền khối Elmich Hera,Elmich,338200,Việt Nam,Nồi và chảo,670000,331800,50
94778000,"Ô Dù che nắng, che mưa, có nút bấm 2 chiều, hàng chất lượng, dễ thương, thiết kế sang trọng và bền bỉ, ô dù có lựa chọn màu sắc",XUDI,196000,Việt Nam,"Áo mưa, ô dù và phụ kiện đi mưa",196000,0,0
89980825,"Bộ 2 nhả kem đánh răng tự động OENON, Kệ nhà tắm thông minh kèm cốc láp đặt dán tường - 2NHAKEM",OENON,229000,Trung Quốc,,400000,171000,43
161024967,Combo 2 hộp chia ngăn sắp xếp quần áo phong cách Nhật Bản Mai Anh House,Mai Anh House,199000,Việt Nam,Nội thất phòng ngủ,199000,0,0
168837331,Giấy Nến Lót Nồi Chiên Không Dầu Hình Khuôn Bánh Siêu Tiện Lợi - Thấm Giảm Thiểu Tối Đa Dầu Mỡ Bám - Hàng Chính Hãng MINIIN,MINIIN,9000,Việt Nam / Trung Quốc,Phụ kiện nhà bếp,65000,56000,86
154157961,"Màn Dây Không Cửa FUNU Chống Muỗi Cao Cấp, Vải Màn Mềm, Mịn, Mắt Dày Dặn Chống Muỗi Tuyệt Đối - Hàng Chính Hãng",FuNu,111150,Việt Nam,Phụ kiện phòng ngủ,117000,5850,5
135442364,"Kéo Cắt Tỉa Cành Cây Deli Chính Hãng 210mm - Lưỡi Thép Sắc Bén, Siêu Bền, Tay Cầm Đệm Cao Su An Toàn, Chắc Chắn - DL2789",Deli,109000,Trung Quốc,Dụng cụ làm vườn,196200,87200,44
269844402,"Phân Bón Sen Đá Greenhome, Gói 24 Viên, Kích Rễ, Lên Màu Chuẩn, Dùng Cho Cây Mọng Nước, Xương Rồng",Greenhome,18900,Việt Nam,"Hoa tươi, Cây cảnh & Hạt giống",35000,16100,46
263487961,Vỉ 2 Viên Pin Sạc AA Energizer 2300 mAh ( 1500 Lần sạc lại ) Made in JAPAN - Hàng chính hãng,Energizer,210000,Nhật Bản,Pin và dụng cụ sạc pin,250000,40000,16
23536038,Kệ đựng bàn chải đánh răng 3 ngăn dán tường nhà tắm đa năng Hobby home decor CD4M loại inox 304 kèm keo dán dính,Hobby Home Decor,190000,Trung Quốc,,200000,10000,5
180575249,"Bộ Tua Vít Đa Năng 115 Chi Tiết, Đầu Vít Bằng Thép Hợp Kim HRC60, Có Từ Tính - Chuyên Sửa Điện Thoại, Laptop, Các Thiết Bị Điện Tử - Hàng Chính Hãng",DORON the best service,150000,Trung Quốc,Các loại máy và phụ kiện,150000,0,0
204207230,"Nhang nụ trầm hương đốt xông nhà tẩy uế HÀ XÁ đồ thờ cúng phong thủy, xua đuổi vận xui, thu hút nguồn năng lượng tích cực, thanh lọc không khí, an toàn cho sức khỏe",Trầm Hương Hà Xá,89000,Việt Nam,,198000,109000,55
58451521,Combo 2 Miếng Lau Nhà Parroti Magic MG01 – Kích Thước 32x10 CM - Chất Liệu Microfiber Cao Cấp,Parroti,49000,Trung Quốc,Dụng cụ lau nhà,49000,0,0
184591044,"Đèn Pixar, Đèn Bàn Chống Cận Thị, Đèn Đọc Sách LED, Đèn Làm Việc Bảo Vệ Mắt - Hàng Chính Hãng",PEAFLO,204000,HK/TQ,Đèn học và đọc sách,320000,116000,36
275234971,Băng Keo Chống Dột Mái Tôn Chống Thấm 10cm x 5m,PEAFLO,59000,Thái Lan / Trung Quốc / Malaysia (Tùy từng đợt nhập hàng),Dụng cụ sửa chữa nhà cửa,75000,16000,21
273636656,Đèn năng lượng mặt trời Vạn Năng Solar 40w,Vạn Năng Solar,50000,Trung Quốc,Đèn ngoài trời,50000,0,0
273027130,Hộp Đựng Cơm Inox Giữ Nhiệt Deli- An Toàn Khi Sử Dụng Lò Vi Sóng Chống Tràn Đa Chức Năng Giá Đỡ Điện Thoại,Deli,159000,Trung Quốc,Dụng cụ chứa đựng thực phẩm,286200,127200,44
75340681,"Hộp Đựng Đồ Đa Năng TD1 – Túi Vải Đựng Quần Áo Chăn Màn Phong Cách Thụy Điển Sang Trọng, Lịch Sự – Hàng Chính Hãng",miDoctor,84000,Việt Nam,Nội thất phòng ngủ,160000,76000,48
253160800,Áo mưa cao cấp Sakos / Liên Á cánh dơi có kính đèn chiếu xa cho xe máy,Sakos,70000,Việt Nam,"Áo mưa, ô dù và phụ kiện đi mưa",90000,20000,22
275137591,"Gối công thái học EMA thế hệ thứ 2 - Chống đau cổ vai ngáy, chống ngủ ngáy, hỗ trợ ngủ nhanh",Ema,699000,Trung Quốc,"Gối, ruột gối, vỏ gối",1398000,699000,50
121162213,Set 10 Móc Treo Quần Áo Người Lớn Jodily inox 304 Sáng Bóng Bền Mãi Với Thời Gian,Jodily StarHome,150000,Việt Nam,Phụ kiện giặt ủi,150000,0,0
271217228,Ly nhựa 2 lớp LocknLock Rainbow HAP507WHTH - kèm ống hút - Dung tích 750ml,LocknLock,113000,Trung Quốc,"Ly, cốc & phụ kiện ly",217000,104000,48
94700631,Chiếu Mây Điều Hòa Cao Cấp TOKDODO,TOK DO DO TOKDODO TOK DO DO,122550,Việt Nam / Trung Quốc,Phụ kiện phòng ngủ,129000,6450,5
103508184,Đèn LED chiếu gương cảm biến 8w chính hãng Rạng Đông Model: G04.PIR 8W,Rạng Đông,181400,Việt Nam,,181400,0,0
1985161,5M Giấy Dán Tường - Decal dán tường Xọc Trắng Xanh Ngôi Sao,ZOOYOO,109000,,Decal & giấy dán tường,109000,0,0
55481938,"Đồng hồ gỗ LED để bàn cao cấp, có nhiệt độ, ngày tháng năm, cảm biến âm thanh",OEM,200000,Trung Quốc,Đồng hồ,200000,0,0
273595615,"Keo Siêu Dính Đa Năng - Keo Dán Siêu Chắc Mọi Bề Mặt, Nhanh Khô, Không Làm Hỏng Bề Mặt Tường, Không Cần Khoan Đục - HÀNG CHÍNH HÃNG MINIIN",MINIIN,15000,Trung Quốc,Dụng cụ sửa chữa nhà cửa,15000,0,0
179445802,"Ghế Xoay Văn Phòng Công Thái Học Có Ngả Lưng TANNI Premium 01 Plus, Ghế Làm Việc Ergonomic Cao Cấp Nhập Khẩu",OEM,830000,Đài Loan,"Nội thất phòng học, làm việc",1590000,760000,48
273428815,Túi Vải Canvas Đựng Bình Ly Cốc Giữ Nhiệt tiện lợi đi học đi làm đi chơi - ELEMENTAL,Elemental,64000,Mỹ,"Ly, cốc & phụ kiện ly",75000,11000,15
275063910,Bộ Drap gối  Thun Hàn Quốc 4 món { drap và 3 áo gối,BP DRAP BÍCH PHƯỢNG,159000,Việt Nam,,159000,0,0
167610326,"Đệm Gấp Văn Phòng - Tặng Kèm Gối Hơi - Chất Liệu Bông Ngọc Trai Dài 190x70 Cm, Dày 1,5 Cm - Đệmệm Gấp Ngủ Trưa Văn Phòng Siêu Nhỏ Gọn - Foldable Sleeping Office Mattress",SKYPIEA,400000,Việt Nam / Đài Loan,Nệm và phụ kiện,400000,0,0
53830664,Mùng ngủ không cửa giăng dây 4 góc truyền thống - Vải tuyn dày lỗ nhỏ chống muỗi tuyệt đối,A,110000,Việt Nam,Phụ kiện phòng ngủ,155000,45000,29
205819517, Bóng đèn Led thông minh Xiaomi Yeelight Bulb W3 đui xoắn E27 (RGB 16 triệu màu) - tích hợp Razer Chroma,Yeelight,253820,Trung Quốc,Bóng và linh kiện đèn,350000,96180,27
276081286,Gối Tựa Lưng Văn Phòng NOOZ Home Goods Chất Liệu Memory Foam Ruột Cao Su Non Đệm Êm Ái Cho Người Đau Thắt Lưng,NOOZ,329000,Trung Quốc,"Gối, ruột gối, vỏ gối",475000,146000,31
253426386,"Cầu là quần áo , bàn để ủi đồ Lock&Lock ETM524",LocknLock,342000,Việt Nam,Phụ kiện giặt ủi,352000,10000,3
253133906,"Hũ thủy tinh làm sữa chua 200ml dáng béo bụng , hũ thủy tinh đựng hương liệu, mật ong, làm sữa chua",PEAFLO,65000,Việt Nam,Dụng cụ chứa đựng thực phẩm,75000,10000,13
275229479,"CỌ TOILET CAO CẤP, CỌ CONG 2 MẶT, CHỔI CỌ BỒN CẦU NHỰA VIỆT NHẬT - HÀNG VIỆT NAM",Việt Nhật,42000,Việt Nam,Dụng cụ vệ sinh,65000,23000,35
54412879,Lô 4 túi rác tiện dụng Soji - size 10L - 25L và 50L,Inochi,79000,Việt Nam,Dụng cụ vệ sinh,79000,0,0
16093882,Phích Cắm Chuyển Đổi 3 Chấu Sang 2 Chấu Milliken NL-3106,Milliken Tampe,15000,,"Ổ cắm, ổn áp, biến áp",15000,0,0
158601820,"Nệm Bông Trải Sàn Xuất Nhật Fukoji, Kích Thước 1mx2m, 1m4x2m, 1m6x2m dày 7-9cm",OEM,399000,Việt Nam,Nệm và phụ kiện,500000,101000,20
197529564,"Đèn Ngủ Oval Thông Minh Kèm Remote, 10 Cấp Độ Sáng, Hẹn Giờ Tắt - Chính Hãng NAVIVU",NAVIVU,219000,Trung Quốc,Đèn ngủ,219000,0,0
134360748,Pin CR2032 Panasonic Lithium 3V - 1 Viên,Panasonic,15000,Trung Quốc,Pin và dụng cụ sạc pin,15000,0,0
157511267,"Ổ Cắm Thông Minh 16A - Ổ Cắm Wifi Rạng Đông 3500W - Chức Năng Hẹn Giờ, Điều Khiển Từ Xa Bằng Điện Thoại ",Rạng Đông,189000,Việt Nam,"Ổ cắm, ổn áp, biến áp",189000,0,0
263021944,"Xi Phông Chậu Rửa Bát 2 Hố Pimisi PXP-31-2 Inox Cao Cấp Kiểu Chun Uốn - Kim Loại Bẻ Cong Được, Thoát Nước Nhanh, Dùng Để Xả Thải Nước Bồn Rửa Chén 2 Hộc Thu 110 Inox 304, Chống Mùi Hôi Và Côn Trùng Gián, Chuột Cắn Phá - Có Đầu Thoát Tràn | Hàng Chính Hãng",Pimisi,293000,Việt Nam,Phụ kiện nhà bếp,500000,207000,41
173632748,Áo Mưa Cánh Dơi Vải Dù 2 Đầu,PEAFLO,133000,Thái Lan / Trung Quốc / Malaysia (Tùy từng đợt nhập hàng),"Áo mưa, ô dù và phụ kiện đi mưa",180000,47000,26
190726741,"Bẫy Chuột Thông Minh Greenhome, D14xr9cm, Lò Xo Độ Nhạy Cao, Lực Gấp Mạnh, Dễ Dùng, Hiệu Quả Cao, Tái Sử Dụng Nhiều Lần",Greenhome,10000,Việt Nam,"Dụng cụ diệt chuột, côn trùng",21000,11000,52
201305691,Bình giữ nhiệt Lock&Lock x Việt Nam phiên bản đặc biệt 897ml LHC4160 kèm cọ rửa và ống hút đầu Silicone - JoyMall,LocknLock,393200,Hàn Quốc / Trung Quốc,Bình/ Ly giữ nhiệt,715000,321800,45
157501727,Đồng Hồ Dán Tường 3D Trang Trí Decor Dễ Lắp Đặt - Phong Cách Châu Âu Độc Đáo - Hàng Loại 1,MINIIN,58000,Trung Quốc,Đồng hồ,99000,41000,41
196768917,Cây lau nhà tự vắt 2 ngăn tách nước sạch nước bẩn riêng biệt Joybos JBS-ZXTB-M16-OGY2P - Hàng nhập khẩu,Joybos,349000,HK/TQ,Dụng cụ lau nhà,349000,0,0
273554998,Trung Nguyên Legend - Phin nhôm hoa văn Trung Nguyên - Màu nâu,Trung Nguyên Legend,79000,Việt Nam,"Bình, ly uống cà phê và phụ kiện",79000,0,0
275213905,"Bộ hộp thực phẩm chữ nhật HOKORI 6560, Bộ hộp đựng thực phẩm Nhựa Việt Nhật cao cấp có khóa cài chắc chắn - Hàng Việt Nam",Việt Nhật,299000,Việt Nam,Dụng cụ chứa đựng thực phẩm,499000,200000,40
148883107,Gương Dán Tường Thủy Tinh Độ Trong Suốt Cao Hình Ảnh Sắc Nét Không Móp Méo,OEM,350000,Trung Quốc,Nội thất phòng ngủ,350000,0,0
191140182,"Phân Trùn Quế Viên Nén Greenhome, Lavamix, Bao 1kg, Dinh Dưỡng Hữu Cơ, Không Mùi, Tốt Cho Lan, Bonsai, Rau, Cây Ăn Trái",Lavamix,44900,Việt Nam,"Hoa tươi, Cây cảnh & Hạt giống",80820,35920,44
275219406,"CỌ TOILET CAO CẤP, CỌ CONG 2 MẶT, CHỔI CỌ BỒN CẦU THƯƠNG HIỆU VIỆT NHẬT - Hàng chính hãng",Việt Nhật,39000,Việt Nam,Dụng cụ vệ sinh,39000,0,0
273902288,Cuộn túi hút chân không đựng thực phẩm 1 mặt nhám ( chiều dài mỗi cuộn 500cm) - Henrysa,HENRYSA Bạn của mọi nhà,69000,Việt Nam,Dụng cụ chứa đựng thực phẩm,120000,51000,43
191385630,"Bình Tưới Cây Greenhome, Dudaco, 2 Lít, Thân Bình Dày, Phun Xa 2 Chế Độ, Bơm Nhẹ Tay, Bình Tưới Cây Phun Sương, Bền, Đẹp",Dudaco,57900,Việt Nam,Dụng cụ làm vườn,81000,23100,29
262023184,Vòi bơm hút nước rửa chén inox 304 bóng Hobby Home Decor NRC5 dây dài 120cm,Hobby Home Decor,183000,Trung Quốc,Phụ kiện nhà bếp,198000,15000,8
177705463,Hộp Kim Chỉ May Vá Quần Áo Xách Tay Mini Đa Năng - Hàng Chính Hãng,lilahome,36000,Trung Quốc,Phụ kiện phòng ngủ,59000,23000,39
216095067,"Cân Nhà Bếp, Cân Tiểu Ly Điện Tử Mini Chính Hãng Sailaza SA- 1221",SAILAZA,229000,Việt Nam / Trung Quốc,Dụng cụ làm bánh,229000,0,0
275628338,"Chăn Gối Văn Phòng Cao Cấp ANKAN (15 LỰA CHỌN), Gấu Mềm Mịn, Thời Trang, Thiết Kế Hiện Đại, Xinh Xắn",ANKAN,279000,Việt Nam/ Trung Quốc/ Đức,"Gối, ruột gối, vỏ gối",279000,0,0
185910176,Giấy Nến Vàng Lót Nồi Chiên Không Dầu Sạch Sẽ Tiện Dụng An Toàn Cho Sức Khỏe - 1 set 50 Tờ,Jodily StarHome,85000,China / Vietnam,Phụ kiện nhà bếp,85000,0,0
273308685,"Hộp đựng đũa thìa muỗng dao khử khuẩn chống ẩm mốc dán tường , máy sấy dụng cụ nhà bếp tiệt trùng bằng tia UV - gia dụng thông minh",Electric Cooking Pot,123000,Việt Nam / Trung Quốc,Phụ kiện nhà bếp,160000,37000,23
73314528,Pin CR2025 Energizer Lithium 3V Chính Hãng | Bộ Vỉ 5 Viên,Energizer,63308,USA / China,Pin và dụng cụ sạc pin,64600,1292,2
36568964,thước kep điện tử sợi carbon 0-150mm,OEM,110000,Trung Quốc,Thiết bị đo lường,110000,0,0
136605740,Áo Bọc Bàn Để Ủi Nguyễn Trường Thắng - Ironing Board Cover,Nguyễn Trường Thắng,160000,Việt Nam,Phụ kiện giặt ủi,160000,0,0
241738356,Kéo nhà bếp Crownman 1558651,Crownman,51000,Trung Quốc,"Dao, kéo và phụ kiện",65000,14000,22
106338289,"Dép Lỗ Đi Trong Nhà Tắm Chống Trơn Trượt Nhanh Khô, Thoáng Mát, Mẫu Mới Nhất. Dép Cho Cả Gia Đình",CHIKIGON,155000,China,Phụ kiện nhà tắm,155000,0,0
272620996,"Đèn học LED 3 màu cắm cổng USB bảo vệ mắt, Đèn để bàn cắm sạc có nút cảm ứng 1 chạm 3 chế độ sáng",Nội Thất 5C,95000,Việt Nam,Đèn học và đọc sách,95000,0,0
145750524,"Bộ Giá Đỡ Ke Bàn Gấp Treo Tường KUNBE, Bản Lề Gập Thông Minh Tiết Kiệm Không Gian, Chịu Tải Tốt",KUNBE,115000,Trung Quốc,"Nội thất phòng học, làm việc",115000,0,0
54122078,Pin AAAA Energizer E96 BP2,Energizer,71500,Singapore,Pin và dụng cụ sạc pin,71500,0,0
122911188,"Găng tay cao su siêu dai rửa bát, bao tay cao su rửa chén, vệ sinh nhà cửa, an toàn, không mùi hôi Parroti Active AT01",Parroti,47000,Trung Quốc,Dụng cụ vệ sinh,47000,0,0
275605851,Đinh Tán Rivet Nhôm Không Cần Kìm Bấm,NAVIVU,15000,Trung Quốc,Dụng cụ sửa chữa nhà cửa,15000,0,0
263239664,Pin nút Lithium Philips CR2032P5B/97 vỉ 5 viên,Philips,87000,Trung Quốc,Pin và dụng cụ sạc pin,100000,13000,13
274790774,Combo 2 găng tay rửa chén thần kỳ- Găng tay silicon tạo bọt- Găng tay tạo bọt 1 đôi (Màu ngẫu nhiên) - Hàng chính hãng ,PaKaSa,59000,Trung Quốc,Dụng cụ vệ sinh,118000,59000,50
247661092,Miếng Dán Nam Châm Dán Tường Treo Vật Dụng Đa Năng,NAVIVU,25000,Trung Quốc,,25000,0,0
165219472,"Sét 10 khay giấy bạc,khay bạc đựng thực phẩm lót nồi chiên không dầu chịu nhiệt độ cao",OEM,29000,Việt Nam,Phụ kiện nhà bếp,29000,0,0
60867458,Hộp Quẹt Bật Lửa Khò Gas Mỏ Hàn 1 Tia Cực Mạnh Cao Cấp BCH 526 ( Giao Màu Ngẫu Nhiên ),OEM,189000,Hong Kong,"Bếp nướng, vỉ nướng",189000,0,0
275410902,Cuộn Túi Hút Chân Không Thực Phẩm Một Mặt Nhám Một Mặt Trơn Dạng Hạt Mịn Phù Hợp Cho Tất Cả Các Dòng Máy Hút Chân Không GROFA,Gro-Fa,59000,Trung Quốc,Dụng cụ chứa đựng thực phẩm,59000,0,0
75329068,Kệ Để Lò Vi Sóng Chữ Z - Màu Ngẫu Nhiên,Vĩnh Xuân Thịnh,425000,Việt Nam / Trung Quốc,,425000,0,0
182487120,"Miếng rửa chén hạt nổi siêu sạch Scotch Brite 3M đa năng, công nghệ độc quyền mới, mút kháng khuẩn ngăn vi trùng, không gây mùi, không bám cặn bẩn, dễ dàng vệ sinh (Màu cam/ Màu xanh lục)",3M,24000,Việt Nam,Phụ kiện nhà bếp,29000,5000,17
190510348,"10 Rọ Đựng Phân Tan Chậm Greenhome, R3xC5cm, Dụng Cụ Làm Vườn, Cắm Chậu, Tiện Lợi, Tiết Kiệm Phân Bón, Dễ Sử Dụng",Greenhome,9900,Việt Nam,"Hoa tươi, Cây cảnh & Hạt giống",18000,8100,45
275821494,"Combo 3 Nắp Cống Ngăn Mùi, Đậy Nắp Cống Chống Mùi Hôi, Ngăn Trào Ngược Nhà Tắm, Côn Trùng Bò Từ Dưới Cống Lên",ASSTAR,29000,Trung Quốc/ Việt Nam(SM078),Phụ kiện nhà tắm,29000,0,0
275075060,Bộ dụng cụ trợ lực nâng và di chuyển đồ nặng thông minh  ,Nhà của Mẹ,142500,China / Vietnam,,150000,7500,5
275676780,"Gối Ngủ Chống Đau Mỏi Vai Gáy, Gối Spa Êm Chống Đau Cổ ,Gối Cao Su Non Chống Ngáy- Giảm Mệt",fofaHome,85000,Trung Quốc,"Gối, ruột gối, vỏ gối",99000,14000,14
191553104,"Thùng rác KENZIO 60 lít - Xanh, Vàng, Cam và Xám",KENZIO,180000,"Việt Nam / Hàn Quốc / Ấn Độ / Trung Quốc,...",Dụng cụ vệ sinh,180000,0,0
274616780,"Dụng cụ vệ sinh máy lạnh cao cấp, đuôi 2.5 mét chống thấm, áo vệ sinh máy lạnh, túi làm sạch điều hòa, Điện Lạnh Thuận Dung",Thuận Dung,47000,Việt Nam,Phụ kiện giặt ủi,47000,0,0
21233181,Bình Giữ Nhiệt Thép Không Gỉ Vacuum Bottle Lock&Lock LHC6180-FU (800ml) - Xanh Đậm,LocknLock,372300,Hàn Quốc / Trung Quốc,Bình/ Ly giữ nhiệt,677000,304700,45
272298582,Bóng đèn bắt muỗi ( dùng để thay thế bóng khi bóng chính bị hỏng),FSL,68000,Trung Quốc,,68000,0,0
192788986,Kệ đựng đồ phòng tắm inox 304 xước dán tường Hobby home decor KCNX có keo dán,Hobby Home Decor,178000,Việt Nam,,178000,0,0
83480720,"Combo 2 Túi Bạt Đựng Quần Áo, Chăn Mền (Giao Ngẫu Nhiên) Chống Thấm Nước, Bộ 2 Giỏ Sọt Đựng Đồ Dơ Họa Tiết Vintage miDoctor",miDoctor,67000,Trung Quốc,Phụ kiện giặt ủi,120000,53000,44
36709098,MÁY ĐỒNG HỒ TREO TƯỜNG KIM TRÔI CAO CẤP EASTAR – BỘ KIM VÀNG ĐỒNG CÓ DẠ QUANG  – KÈM PIN MAXELL,Eastar,99000,Trung Quốc,Đồng hồ,99000,0,0
87624516,Hạt giống hoa Cúc Bách Nhật nhiều màu VTS147,Sen Vàng Seeds,16536,Hà Lan,"Hoa tươi, Cây cảnh & Hạt giống",16536,0,0
247655879,"Bàn để ủi, cầu là quần áo dạng đứng LEBENLANG LBB363, khung bằng thép tặng tấm lót thay thế - hàng chính hãng ",Lebenlang,629000,Trung Quốc,Phụ kiện giặt ủi,959000,330000,34
77765130,Muỗng silicon DandiHome cao cấp chịu nhiệt cực tốt dùng để nấu ăn,DandiHome,101650,Việt Nam,Phụ kiện nhà bếp,119000,17350,15
196518627,"Combo 20 Móc Treo Ảnh Gắn Tường, Đinh 3 Chân Treo Tranh, Đồ Trang Trí Decor - Chính Hãng",lilahome,19000,Trung Quốc,Phụ kiện giặt ủi,19000,0,0
2153015,Bộ Vít 24 Món Xiaomi Wiha Precision Screwdriver,Xiaomi,490000,Trung Quốc,Các loại máy và phụ kiện,490000,0,0
20266547,"Bộ 3 móc treo quần áo, khăn 5 tầng thông minh tiện dụng",OEM,89000,,Phụ kiện giặt ủi,115000,26000,23
248538753,Bộ Cây Lau Nhà Đa Năng LET-GREEN (Có Sẵn Khăn Giấy Kèm Quà Tặng),Let-green,225000,Việt Nam,Dụng cụ lau nhà,250000,25000,10
144635989,Hạt giống Măng Tây Tím - Hạt giống Rạng Đông,Hạt giống Rạng Đông,9702,Việt Nam,"Hoa tươi, Cây cảnh & Hạt giống",9900,198,2
39318884,Hộp 60 Viên Pin AA Panasonic ( Pin Tiểu ) Hi Top - Hàng Chính Hãng,Panasonic,175000,Indonesia,Pin và dụng cụ sạc pin,175000,0,0
72128693,Bình xịt phun sương tưới cây bình áp suất nén khí cao cấp 2 lít,OEM,119000,Trung Quốc,Dụng cụ làm vườn,135000,16000,12
217889831,Khăn Tay Nén Cotton Beyaki 30 Viên 24x30 cm,Beyaki,45000,Trung Quốc,Khăn,60000,15000,25
272349192,"Tủ Kệ Sách Đa Năng FIVO FB03, Thiết Kế Chắc Chắn Có Tấm Lưng, Phù Hợp Mọi Không Gian, Dễ Dàng Lắp Ráp, Decor Linh Hoạt",FIVO,243000,Việt Nam,"Nội thất phòng học, làm việc",468000,225000,48
274173764,Máy Rửa Xe Xịt Rửa Cầm Tay Dùng Pin 48V Áp Lực Cao Phun Nước Đa Năng tặng bình tạo bọt,PEAFLO,419000,Hàn Quốc / Trung Quốc,Máy xịt rửa và phụ kiện,419000,0,0
200792980,[Nhiều màu] Vỏ Gối Ôm Gòn Bedding Lụa Tencel 60s Cao Cấp Màu Trơn 37x105 cm,Gòn Bedding,229000,Việt Nam,"Gối, ruột gối, vỏ gối",229000,0,0
275439067,Ron cao su dùng cho nồi áp suất GAS 3 lít đến 6 lít,Rainy,55000,China,Phụ kiện nhà bếp,55000,0,0
77913133,Dụng cụ kẹp gắp đồ nóng DandiHome inox 304 với mút silicon chống trơn trượt,DandiHome,101650,Trung Quốc,Phụ kiện nhà bếp,115000,13350,12
35905859,Đầu Cây Lau Nhà Pva Lock&Lock ETM481RFL - Mixed 32.7 x 6 x 4cm,LocknLock,59900,Trung Quốc,Dụng cụ lau nhà,109000,49100,45
2391311,Cân Treo Mini Bỏ Túi 1 Mặt Số 5kg Nhơn Hòa NHMGS-5 - Hàng Chính Hãng,Nhơn Hòa,64000,Việt Nam,Dụng cụ làm bánh,64000,0,0
272424614,"Đồng Hồ Pomodoro Hình Khối Lập Phương KUNBE Đếm Ngược Hẹn Giờ Nấu Ăn, Tập Thể Dục, Quản Lý Thời Gian Hiệu Quả",KUNBE,92000,Trung Quốc,Đồng hồ,92000,0,0
274022444,"Chuông Cửa Không Dây Thông Minh Teement TM01 , Chống Nước Khoảng Cách Sử Dụng Trong 300M - Hàng Chính Hãng",TEEMENT,200000,Trung Quốc,Bảo vệ nhà cửa,200000,0,0
274022444,"Chuông Cửa Không Dây Thông Minh Teement TM01 , Chống Nước Khoảng Cách Sử Dụng Trong 300M - Hàng Chính Hãng",TEEMENT,200000,Trung Quốc,Bảo vệ nhà cửa,200000,0,0
275906308,Bình Thủy Inox Rạng Đông RD1040 ST2 (1L),Rạng Đông,165000,Việt Nam,Bình/ Ly giữ nhiệt,165000,0,0
104269182,"Cân Điện Tử Nhà Bếp Có Đế Chống Trượt, Cảm Ứng Đo Chính Xác, Mặt Kính Tròn Tải Trọng 5kg - Hàng Chính Hãng",MORADO,185000,Trung Quốc,Dụng cụ làm bánh,185000,0,0
275348591,Móc Dán Tường Treo Đồ Nặng INOX 8KG Siêu Dính Chịu Lực Trang Trí Decor Tường,GUANG MING,15000,Trung Quốc,,25000,10000,40
196336630,"Túi Đựng Hộp Cơm Giữ Nhiệt Grepaco Nhiều Ngăn Đựng Đồ Thức Ăn Nóng Lạnh Văn Phòng, Mẹ Bỉm Du Lịch – Vải Bố Canvas, Kích Thước Size To (Cỡ Lớn), Kiểu Quai Xách Và Đeo Vai - Tặng Túi Đựng Muỗng Nĩa - Hàng Chính Hãng",GREPACO,99000,Việt Nam,Phụ kiện nhà bếp,99000,0,0
272135703,Bộ tua vít nam châm đa năng 24 đầu PaKaSa - Hàng Chính Hãng ,PaKaSa,118000,Trung Quốc,,118000,0,0
190755146,"Hạt Giống Khổ Qua Greenhome, Gói 0,5gr, Dễ Trồng Quanh Năm, Nảy Mầm Cao, Thu Hoạch Nhanh, Năng Suất Cao T05",SENVANG SEEDS,10000,Việt Nam,"Hoa tươi, Cây cảnh & Hạt giống",17820,7820,44
271064543,Bình giữ nhiệt Lafonte 180756-GRE 500ml,La Fonte,160000,Trung Quốc,Bình/ Ly giữ nhiệt,231000,71000,31
109854689,"Gối kê lưng Ema cho người đau mỏi thắt lưng, thoát vị đĩa đệm, bà bầu, người cao tuổi, dân văn phòng",Ema,235000,Trung Quốc,"Gối, ruột gối, vỏ gối",470000,235000,50
54026297,Máy Đo Khảng Cách Xiaomi Laser DUKA LS-P - Hàng Nhập Khẩu,Xiaomi,391020,Trung Quốc,Thiết bị đo lường,399000,7980,2
53651774,"CỌ LƯNG SILICON, DÂY CỌ LƯNG SILICON",OEM,53200,Italia / Trung Quốc,Phụ kiện nhà tắm,56000,2800,5
275685136,"Xịt Đuổi Chuột XS Thái Lan Đuổi Chuột Trong Nhà, Gầm Máy Ô tô, Không Gây Độc Hại An Toàn cho Người",fofaHome,49000,Việt Nam,"Dụng cụ diệt chuột, côn trùng",59000,10000,17
67244462,Hạt giống rau quế - húng quế - É Quế gói 5g VTS98,Sen Vàng Seeds,13000,Việt Nam,"Hoa tươi, Cây cảnh & Hạt giống",13000,0,0
190253798,"Nhựa cây đốt xông nhà bảo vệ và thanh tẩy, chiêu tài lộc",Song An Eco,120000,Việt Nam,,120000,0,0
275282050,Mền lông cừu xám cao cấp A - 1m8x2m,A,175000,Thái Lan,"Chăn, mền và phụ kiện",220000,45000,20
274558570,"(Ngang 45-75cm) Tủ Nhựa Gấp Gọn Size Lớn, Tủ Đựng Quần Áo Đa Năng Lắp Ghép, Để Đồ Tiện Dụng, Nhựa PP, Có Bánh Xe",Nubie,264000,Trung Quốc,Nội thất phòng ngủ,264000,0,0
172936142,Bàn làm việc khung thép chống ghỉ sơn tĩnh điện chính hãng IGA - GM09,IGA,255000,Việt Nam,"Nội thất phòng học, làm việc",255000,0,0
275400205,"Bộ 4 Chân Kê, Đế Chống Rung Nâng Đỡ Máy Giặt Tủ Lạnh Đa Năng Điều Chỉnh Độ Cao Chống Rung Lắc",fofaHome,41000,Việt Nam,Phụ kiện giặt ủi,46000,5000,11
76539039,Ly giấy 6.5oz~192ml - Lốc 50 ly giấy trơn,New Star Paper,23000,Việt Nam,"Ly, cốc & phụ kiện ly",23000,0,0
162875961,Hộp 10 Đôi Đũa  Sừng Chất Liệu Hợp Kim Mạ Vàng Cao Cấp Đầu Đũa Có Chống Trơn - Hàng Loại 1 - Chính Hãng MINIIN,MINIIN,32000,Nhật Bản / Trung Quốc,"Đũa, muỗng, nĩa",32000,0,0
249153233,Hộp Thủy Tinh Chịu Nhiệt Lock&Lock 530ml LCB425,LocknLock,105000,Trung Quốc,Dụng cụ chứa đựng thực phẩm,189000,84000,44
273280478,Ruột gối ôm K-Bedding by Everon - Trắng,K-Bedding,137750,Việt Nam,"Gối, ruột gối, vỏ gối",180000,42250,23
173854526,"Chai Tẩy Rỉ Sét Và Bôi Trơn  3M 5-W - Hàng chính hãng - Tẩy sét, bôi trơn các loại ổ khóa, khe cửa lùa, đẩy nước ra khỏi ổ khóa xe, bugi, công tắc ôtô xe máy sau khi rửa xe, ngập nước.",3M,80000,Việt Nam,"Sơn, dầu mỡ, hóa chất",80000,0,0
164321546,"Ghế Xoay Văn Phòng Công Thái Học Ergonomic Có Ngả Lưng Premium V1, Ghế Xoay Ngồi Làm Việc Cao Cấp Nhập Khẩu","	OEM",1598000,Đài Loan,"Nội thất phòng học, làm việc",3300000,1702000,52
275467729,Bạt PVC trong suốt chống thấm nước - Độ dày 0.4mm che mưa lấy sáng ngoài - May viền khuy sẵn,N NN VIETNAM In Quality We Different,105000,Việt Nam,Ngoại thất sân vườn,105000,0,0
173732608,"Combo Khăn Lau Đa Năng 2 Mặt Siêu Thấm , Khăn Lau Bếp , Khăn Lau Kính , Khăn Lau Chén Bát , Khăn Lau Tay , Khăn Lau Ô Tô PaKaSa",PaKaSa,19000,Trung Quốc,Phụ kiện nhà bếp,38000,19000,50
115334461,"Combo 2 Lõi cây lăn bụi ,Lông Động Vật, Sợi Vải, Đồ Da, Chăn Nệm, Ghế Salon",OEM,29000,Hong Kong,Phụ kiện giặt ủi,45000,16000,36
249253343,"Bộ nồi 5 đáy Inox 304 Elmich Berlin EL 3981 Size 18, 20cm",Elmich,782000,Việt Nam,Nồi và chảo,1890000,1108000,59
274974920,"Túi Lưới Giặt Đựng Áo Lót 26,5x31,5cm - Túi Giặt Bảo Vệ Áo Ngực Chuyên Dụng Vải Dày - Túi Đựng Quần Áo Cho Máy Giặt",SOHOGO,69000,Trung Quốc,Phụ kiện giặt ủi,69000,0,0
250017470,Combo 4 pin sạc AA 3000mAh kèm sạc BESTON C9009 - sạc nhanh tự ngắt - có đèn báo pin đầy - Hàng  nhập khẩu,BESTON,225000,Trung Quốc,Pin và dụng cụ sạc pin,225000,0,0
105632980,Combo nệm ngủ trưa văn phòng cao cấp A 80x190cm + 1 gối hơi 35 x 50 cm - tặng kèm 1 vỏ gối cotton poly cùng màu,A,240000,Trung Quốc,Nệm và phụ kiện,300000,60000,20
274944917,"Thanh treo rèm cửa, treo quần áo bằng inox, không cần khoan tường hay bắt vít, cực kỳ tiện dụng - hàng chính hãng",Nhà của Mẹ,90000,Việt Nam,Nội thất phòng khách,90000,0,0
195109419,"Bộ nồi inox dập nguyên khối Elmich Trimax Classic EL-2108OL Size 18, 20cm",Elmich,899100,Trung Quốc,Nồi và chảo,1700000,800900,47
139106099,"Túi Đựng Ly Giữ Nhiệt Grepaco Dạng Quai Xách Và Dây Rút Đựng Bình Nước Thể Tích 500ml, 750ml, 800ml, 900ml, 1500ml – Vải Bố Canvas Dù Chống Thấm Nước Phong Cách Thời Trang Bảo Vệ Môi Trường Phong Cách Nhật Bản",GREPACO,49000,Việt Nam,Bình/ Ly giữ nhiệt,49000,0,0
247860144,Thùng Rác Nắp Bật Nhấn Nút Thông Minh Deli - Tiết Kiệm Không Gian Nhựa PP Nguyên Sinh Hạn Chế Mùi Hôi Kháng Khuẩn Sọt Rác Văn Phòng Nhà Bếp - 1108 1109,Deli,129000,Trung Quốc,Dụng cụ vệ sinh,232200,103200,44
273280771,"Ruột Gối Nằm K-Bedding by Everon - Trắng, Gối Cao",K-Bedding,77000,Việt Nam,"Gối, ruột gối, vỏ gối",77000,0,0
274556327,"Bộ nồi chống dính men sứ Elmich EL -5204SK size 18,20,24cm - Hàng Chính Hãng",Elmich,834300,Việt Nam,Nồi và chảo,2290000,1455700,64
202840456,Kệ Lò Vi Sóng Effect Đa Năng - GM02,IGA,139000,Việt Nam,,139000,0,0
275088891,"Thảm ngủ trưa văn phòng, tấm lót, chiếu ngủ trưa văn phòng đa năng EMA",Ema,65000,Trung Quốc,Phụ kiện phòng ngủ,130000,65000,50
119030223,"Keo Dán Giày, Gỗ, Nhựa, Sứ Siêu Dính Chống Thấm Đa Năng Deli - 7Ml / 20Ml - 7140 / 7149",Deli,9000,Trung Quốc,Dụng cụ sửa chữa nhà cửa,16200,7200,44
69943599,"Bộ 2 giá đỡ Ke bàn gấp treo tường thông minh thép không gỉ - Dùng cho bàn học, bàn ăn, bàn làm việc, kệ trang trí – MH2011",MIHOCO,265000,Việt Nam,"Nội thất phòng học, làm việc",265000,0,0
273672038,Ly nhựa 2 lớp Bubble Tea Cold Cup LocknLock HAP529 - Kèm ống hút - Dung tích 720ml,LocknLock,108000,Trung Quốc,"Bình, ly uống trà và phụ kiện",217000,109000,50
176451792,"Bộ Dụng Cụ Sửa Chữa Đa Năng 49 Chi Tiết Deli Cao Cấp Chính Hãng - Sử Dụng Nhiều Mục Đích, An Toàn, TIện Lợi - DL5969",Deli,2158200,Trung Quốc,,2158200,0,0
275376284,TỦ NHỰA ĐỂ GIÀY DÉP KIỂU MỚI 12 Ô (chia ô) CỬA TRẮNG TRONG - HÀNH CHÍNH HÃNG,Anh Lam Store,412000,Trung Quốc / Singapore / Việt Nam,Nội thất phòng khách,550000,138000,25
71526385,"Đèn LED cảm ứng, cảm biến thông minh không dây, Pin sạc, nhận diện người có nam châm gắn tường xoay 360 độ làm đèn học, cho phòng ngủ, nhà vệ sinh, cho tủ quần áo, cầu thang, ban công, hành lang - MH2011",MIHOCO,165000,Đài Loan,,165000,0,0
273551962,Chăn hè K-Bedding by Everon chất vải Cool Flex (thun lạnh) mềm mát KCSP,K-Bedding,693500,Việt Nam,"Chăn, mền và phụ kiện",1000000,306500,31
263571418,"Ô Dù Che Mưa, Che Nắng, Có Nút Bấm Tự Động Đóng Mở, Gấp Gọn Tiện Lợi,  Thiết Kế Sang Trọng Và Bền Bỉ, Ô Dù Có Lựa Chọn Màu Sắc- Hàng Chính Hãng Besti",Besti,160000,Trung Quốc,"Áo mưa, ô dù và phụ kiện đi mưa",160000,0,0
48373983,Ổ CẮM CHUYỂN ĐỔI 3 CHẤU – KÈM CÔNG TẮC TOSHINO – CO-6S,TOSHINO,55000,,,55000,0,0
197143009,"Qui Phúc Ghế xếp lưới cafe, trà chanh",Qui Phúc,179000,Việt Nam,Nội thất phòng ăn,179000,0,0
199945017,"Bọc Nệm,Aó Nệm Topper 2 Mặt Có Khóa Khéo Vải Cotton Tici Thoáng Mát Kích Thước 1m/1m2/1m4/1m6/1m8 x 2m dày 5-9cm",RioTex,150000,Việt Nam,,250000,100000,40
27826567,"Dụng cụ ép tỏi, nghiền tỏi có tay cầm tiện dụng",OEM,27000,,Phụ kiện nhà bếp,40000,13000,33
275258477,ĐÈN NĂNG LƯỢNG MẶT TRỜI 300W – CHIP LED 5054 THẾ HỆ MỚI SIÊU SÁNG,HIKITECH,799000,Trung Quốc,Đèn ngoài trời,799000,0,0
94186847,GHẾ THƯ GIÃN HẠNG SANG HAKAWA HK-G22 - HÀNG CHÍNH HÃNG,HAKAWA,2280000,Trung Quốc,Nội thất phòng ngủ,2280000,0,0
8141095,"Bình nước Lock&Lock Aqua HAP739B/HAP739W 2,6L",LocknLock,66000,Việt Nam,,109000,43000,39
275396744,"Combo 6 cuộn Túi đựng rác văn phòng, Bao đựng rác trường học tiện lợi màu đen size đại 64x78",Túi ni lông tự phân hủy sinh học GIMEX II,42000,Việt Nam,Dụng cụ vệ sinh,42000,0,0
75356087,Túi Đựng Hộp Cơm Giữ Nhiệt Đa Lớp Cỡ Lớn 34cm*25cm*15cm,OEM,59400,Trung Quốc,Phụ kiện nhà bếp,59400,0,0
140221254,Dụng Cụ Xay Tỏi Ớt Cầm Tay Máy Xay Thịt Bằng Tay Mini Đa Năng Lưỡi Cắt Thép Không Gỉ An Toàn Thực Phẩm 650ml KONKA KJ-LS01 - Hàng Chính Hãng,KONKA,104000,Trung Quốc,Phụ kiện nhà bếp,194000,90000,46
54819042,Bình Giữ Nhiệt Nóng Lạnh Camelbak Chute Mag Insulated Stainless Steel 1L,CamelBak,999000,Trung Quốc,Bình/ Ly giữ nhiệt,999000,0,0
42354346,"Gối Chữ U Kèm Bịt Mắt, Bịt Tai – Gối Ngủ Du Lịch, Tựa Đầu Chống Mỏi Chất Liệu Memory Foam Chính Hãng miDoctor – mi1711",miDoctor,144000,Trung Quốc,"Gối, ruột gối, vỏ gối",149000,5000,3
271847965,"Khăn giấy 4 lớp treo tường dạng rút tiết kiệm, an toàn, tiện lợi",PEAFLO,109000,HK/TQ,Phụ kiện phòng ăn,120000,11000,9
119112667,Combo 2 Miếng Lau Nhà Parroti ProMAX - Kích Thước 38 x12 CM,Parroti,89000,Trung Quốc,Dụng cụ lau nhà,89000,0,0
273601296,"Đệm, Nệm Đa Năng Topper Gấp Gọn, Nệm Trải Sàn Siêu Êm, Tốt Cho Sức Khỏe Giúp Bạn Có Giấc Ngủ Thoải Mái ƞhất - Dùng Được Cho 4 Mùa - Hàng chính hãng",Anh Lam Store,306000,Việt Nam,Nệm và phụ kiện,550000,244000,44
193642437,Giường xếp văn phòng ngủ trưa gấp gọn 67x180cm - giường ngủ trưa văn phòng gấp gọn,GARINOTI,529000,Đài Loan,Nội thất phòng ngủ,529000,0,0
275692523,"Túi đựng chăn màn, quần áo - Size lớn 100 Lít vải bố khung sắt có dây rút - HENRYSA",HENRYSA Bạn của mọi nhà,85500,Việt Nam,Phụ kiện giặt ủi,120000,34500,29
275281491,"Bô vệ sinh trong nhà cho người già, người ốm, Bồn cầu di động đa năng",Anh Lam Store,283000,Việt Nam,Dụng cụ vệ sinh,450000,167000,37
168234677,[Hàng chính hãng] Ghế chỉnh dáng ngồi đúng - Curble Wider_Premium Model Hàn Quốc (Made in Korea). Phù hợp mọi đối tượng (Free Size),Ablue,732649,Hàn Quốc,"Nội thất phòng học, làm việc",779000,46351,6
75615959,"Combo 5 khăn lau đa năng siêu thấm hút, khăn size lớn (30x40 cm) khăn lau kính, ô tô, mặt bàn, bếp Parroti Fiber FB01",Parroti,42000,Trung Quốc,Phụ kiện nhà bếp,42000,0,0
275270719,Bình nước nhựa Elmich EL8360 dung tích 1.1L,Elmich,153000,Trung Quốc,,250000,97000,39
245074462,Loại INOX - Đầu Nối Vòi Nước Xoay 1080 độ - Đầu Vòi Nước Thông Minh Lắp Bồn Rửa Mặt - Hai Chế Độ Nước - Hàng Nhập Khẩu,DORON the best service,105000,Trung Quốc,Thiết bị phòng tắm,105000,0,0
274965041,"Máy Bắt Muỗi Thông Minh HIKITECH, Diệt Côn Trùng Đa Năng, Hiệu Quả. Tặng kèm Chổi Vệ Sinh Lồng Đèn",HIKITECH,279000,Trung Quốc / Singapore / Việt Nam,,279000,0,0
275570262,"Thanh treo rèm không cần khoan tường , treo quần áo , treo rèm cửa Housetech HT03",Housetech,55000,Trung Quốc,Phụ kiện giặt ủi,55000,0,0
190755138,"Hạt Giống Hoa Sen Nhật Mini Greenhome, Gói 10 Hạt, Nhiều Màu, Dễ Trồng, Nảy Mầm Tốt H01",Greenhome,12900,Việt Nam,"Hoa tươi, Cây cảnh & Hạt giống",23220,10320,44
35783423,"Kệ gia vị Inox 304 dán tường gạch men - có keo dán Sealant Fix - 3 kích thước - HOBBY KGVD20 , KGVD23, KGVD28",Hobby Home Decor,189050,Trung Quốc,,199000,9950,5
275567609,"Máy khử khuẩn tiệt trùng bàn chải đánh răng bằng tia UV, kiêm kệ nhả kem đánh răng - Giá treo bàn chải khử trùng sạch 99% vi khuẩn - Hàng nhập khẩu",XM,195000,Trung Quốc,,195000,0,0
272363246,"Chảo Inox nguyên khối, chống dính vân đá 3D Elmich Trimax EL2415OL size",Elmich,311600,Việt Nam,Nồi và chảo,404250,92650,23
273244864,Chảo chống dính siêu bền Elmich EL-5942GY - Hàng Chính Hãng,Elmich,221350,Việt Nam,Nồi và chảo,369000,147650,40
93292913,"Cuộn Ron Dán Che Khe Cửa,Chân Cửa HT SYS - Lớp Keo Dán 3M Chống Nước - Chống Gió Lùa - Chống Ồn - Bụi Bẩn - Ngăn Côn Trùng -  Cuộn 25mm/35mm/45mm Dài 2 Mét",HT SYS,33000,Việt Nam / Trung Quốc,Bảo vệ nhà cửa,39000,6000,15
84953200,Kệ đựng dụng cụ rửa chén dán tường inox 304 Hobby Home Decor KRC6,Hobby Home Decor,185000,Trung Quốc,,239000,54000,23
274607715,"Kệ Để Bàn Đựng Kem , Bàn Chải Đánh Răng Kèm 2 Ly - PaKaSa ( Màu ngẫu nhiên)",PaKaSa,69000,Trung Quốc,,138000,69000,50
206242343,"[Chọn Mùi] Nến Thơm Hoa Khô Không Khói, Thư Giãn Tinh Thần, Khử Mùi, Dễ Ngủ",NAVIVU,25000,Trung Quốc,Trang trí nhà cửa khác,25000,0,0
214771223,"Nẹp chèn chân cửa thế hệ mới chặn gió khe cửa chống côn trùng.Thanh chắn cửa chống ồn, chống thoát hơi gió điều hòa GD649-RonU",So Easy,45000,Việt Nam,Bảo vệ nhà cửa,45000,0,0
650496,Hũ Thủy Tinh Nắp Cài Kín Hơi Fido Bormioli Rocco 149220M04321991 (1000ml),Bormioli Rocco,160000,Ý,Dụng cụ chứa đựng thực phẩm,186000,26000,14
249023599,"Ổ Cắm Điện Đa Năng 2500W Có Công Tắc Nguồn 3/4/6 Ổ , 3M/5M Dây Chống Giật Chống Cháy Chất Lượng Cao Deli - Phiên Bản Mới Nâng Cấp 2023 - Hàng Chính Hãng - ET401 - 406",Deli,135000,Trung Quốc,"Ổ cắm, ổn áp, biến áp",243000,108000,44
273509200,Bàn Chải Vệ Sinh Khe Hở Khe Nhà Tắm Khe Cửa Nhà Bếp Nhỏ Gọn,PEAFLO,18000,HK/TQ,Dụng cụ vệ sinh,27000,9000,33
53926593,"Combo 6 cuộn Túi đựng rác văn phòng, Bao đựng rác trường học tiện lợi 3 màu size đại 64x78",Túi ni lông tự phân hủy sinh học GIMEX II,64000,,Dụng cụ vệ sinh,64000,0,0
451852,Cáp nối dài Điện Quang ĐQ EPF 2W.2PN dây dài 2m (Giao màu ngẫu nhiên),Điện Quang,43300,Việt Nam,Phụ kiện nhạc cụ,57608,14308,25
275579431,"Hộp Bẫy Gián Thông Minh Không Hóa Chất Kèm 2 Bịch Mồi, Máy Bắt Gián Thế Hệ Mới Nhỏ Gọn Siêu Hiệu Quả Cho Nhà Bạn",Hier,39000,Trung Quốc,"Dụng cụ diệt chuột, côn trùng",39000,0,0
271300996,"Sào Cưa Tỉa Cắt Cành, Hái Quả Trên Cao KUNBE Có Các Loại Dài  3m, 5m, 6m, 7m Chắc Chắn Cứng Cáp",KUNBE,145000,Trung Quốc,Dụng cụ làm vườn,145000,0,0
57863885,Đồng hồ LED để bàn hình hộp gỗ - Nhiệt kế - Báo thức - Cảm ứng âm thanh,OEM,150000,Việt Nam,Đồng hồ,150000,0,0
274643534,Bộ 3 hộp đựng thực phẩm chữ nhật Hokori - hàng Chính Hãng,Hokori,69000,Việt Nam,Dụng cụ chứa đựng thực phẩm,130000,61000,47
274650574,Móc Treo Thau Kiểu Vuông Dán Tường Chắc Chắn,NAVIVU,19000,Trung Quốc,,19000,0,0
16422707,Vòng Đệm Cao Su 270 cái,Milliken Tampe,59000,,Dụng cụ sửa chữa nhà cửa,59000,0,0
274408257,"Tinh Dầu Thơm Phòng Que Gỗ Tự Khuếch Tán Khử Mùi Nhà Cửa, Làm Thơm Phòng, Nhà Tắm",PEAFLO,52000,Thái Lan / Trung Quốc / Malaysia (Tùy từng đợt nhập hàng),"Đèn xông tinh dầu, tinh dầu và phụ kiện",62000,10000,16
138557005,"Máy Mài Dao , Kéo Bằng Điện 220V KT 21.5*6.5*6.5cm - PaKaSa",PaKaSa,120190,Trung Quốc,"Dao, kéo và phụ kiện",184000,63810,35
274762675,"Phân Bón NPK Greenhome, Chuyên Rau Ăn Lá, Củ, Cây Ăn Trái, Hoa, Dinh Dưỡng Cân Đối, Chắc Rễ, Khoẻ Cây, Bông To, Sai Quả",Greenhome,34900,Việt Nam,"Hoa tươi, Cây cảnh & Hạt giống",62000,27100,44
72750093,"Báo Động Chống Trộm, Chuông Báo Khách Mở Cửa Đa Chức Năng MC - 03, Báo Động Nhiều Chế Độ : Chống Trộm Xâm Nhập , Báo Chuông Cửa..",CTFAST,115000,Trung Quốc,Bảo vệ nhà cửa,124000,9000,7
137026625,"Đèn quang hợp, đèn trồng cây trong nhà 9W, chiếu sáng quang hợp cho cây xanh, trầu bà, lan chi, lộc phát, sen đá, Chính hãng Rạng Đông",Rạng Đông,58000,Việt Nam,,58000,0,0
55202550,Bộ 3 Hộp Thủy Tinh Chịu Nhiệt KOVA (370ml + 640mlx2) Kèm Túi Giữ Nhiệt Họa Tiêt,KOVA,240000,Trung Quốc,Dụng cụ chứa đựng thực phẩm,390000,150000,38
273902315,CB chống giật Panasonic RCBO 2P1E 16A-20A-25A-32A-40A-50A-63A - Hàng chính hãng,Panasonic,460000,Trung Quốc,Thiết bị điều khiển thông minh,465000,5000,1
270635997,Set 5 Đôi Đũa Inox 304 Cao Cấp Phong Cách Hàn Quốc - Hàng Chính Hãng,lilahome,69000,Trung Quốc,"Đũa, muỗng, nĩa",99000,30000,30
196567786,"Rèm cửa sổ chống nắng,trang trí 96% FREE SHIP Màu xanh dương dịu mát Nhiều kích thước",MODERO,58000,Việt Nam,Nội thất phòng khách,68000,10000,15
270660644,"Bộ túi hộp cơm thủy tinh LocknLock 3EA LLG429DS2GRN - (LLG429D*1, LLG428*1, HWB820GRY*1) - Màu",LocknLock,342000,Trung Quốc,Bộ hộp cơm và phụ kiện,682000,340000,50
158973350,"Lư Đốt Trầm Hương, Lư Xông Trầm Bằng Gốm Sứ - Hàng Chính Hãng",MO hi,44100,Trung Quốc,,49000,4900,10
190510350,"Xẻng Xúc Đất Greenhome, D27xR8cm, Dụng Cụ Làm Vườn, Hợp Kim Chống Rỉ, Siêu Bền, Dễ Vệ Sinh, Tiện Lợi",Greenhome,28900,Việt Nam,Dụng cụ làm vườn,44820,15920,36
650492,Hũ Thủy Tinh Nắp Cài Kín Hơi Fido Bormioli Rocco 149280M04321991 (750ml),Bormioli Rocco,156000,Ý,Dụng cụ chứa đựng thực phẩm,180000,24000,13
3341035,Thuốc kích thích ra rễ N3M,N3M,125000,Việt Nam,"Hoa tươi, Cây cảnh & Hạt giống",125000,0,0
159773295,Giá treo quần áo sau cửa không cần khoan Wellex MH600(DR25) hạ 25cm,Wellex,360000,Hàn Quốc,Phụ kiện giặt ủi,360000,0,0
186288399,Lược Bướm Thép Tập Quay CSGO Dùng Tập Luyện - Mô Hình Butterfly CSGO – Lược Butterfly,OEM,59000,Việt Nam,Phụ kiện nhà bếp,59000,0,0
190857198,"Phân Dê Trồng Lan Greenhome, Túi Lưới Dài 10cm, Đã Qua Xử Lý, Không Mùi, Kích Rễ Phong Lan, Hoa Đậm Màu Lâu Tàn",Greenhome,1000,Việt Nam,"Hoa tươi, Cây cảnh & Hạt giống",2000,1000,50
155550676,Bình Giữ Nhiệt Thể Thao 2 Lít Pearl Metal Sportion One D-27697071 2 Kiểu Dáng Năng Động,Pearl Metal,528500,Nhật Bản,Bình/ Ly giữ nhiệt,528500,0,0
64618364,Day Đèn LED Siêu Sáng 5050 RGB Chống Nước Quấn Cây Trang Trí Ngoài Trời,OEM,179000,Trung Quốc,,179000,0,0
24594896,Hộp đựng dao cao cấp XYJ,XYj,232750,Trung Quốc,"Dao, kéo và phụ kiện",245000,12250,5
130385982,"Vòi hoa sen tăng áp  Luva VS4, tăng áp lực nước, hàng chính hãng",Luva,150000,Việt Nam,Thiết bị phòng tắm,150000,0,0
273280485,"[Roichen - WOW] Ghế Roichen - WOW, ghế chỉnh Dáng ngồi đúng có chân xoay_Made in Korea",Roichen,2240000,Hàn Quốc,"Nội thất phòng học, làm việc",2600000,360000,14
169581175,"Áo Trùm Máy Giặt Cửa Ngang, Cửa Trước Size 9kg-10kg, Vải Dù Siêu Dày, Lựa Chọn Họa Tiết",XUDI,105000,Việt Nam,Phụ kiện giặt ủi,105000,0,0
275332135,"Ổ KHÓA CHỮ U 5 SỐ, CÀNG KHÓA 6.5MM CHỐNG KHOAN CẮT",Nhà của Mẹ,99000,China / Vietnam,Bảo vệ nhà cửa,99000,0,0
53034279,"Kệ úp chén bát đĩa, kệ úp chén đa năng, kệ để trên bồn rửa Juno Sofa (Ngang 95, Cao 52 và rộng 32 Cm)",Juno Sofa,294000,,,380000,86000,23
6880341,Cây lau nhà Xiaomi 2 trong 1 - Có phun nước Deerma Spray Water Spray Mop - Hàng Chính Hãng,Xiaomi,248000,Trung Quốc,Dụng cụ lau nhà,248000,0,0
275160552,Bình Nước Thủy Tinh Chịu Nóng Lạnh SC07 Soika Dung Tích Lớn Có Túi Đeo Chéo,Soika,228000,Trung Quốc,,266000,38000,14
270881847,"Cây lau nhà tự vắt thông minh, tự vắt phun sương 3 trong 1 SP02",Parroti,263150,Trung Quốc,Dụng cụ lau nhà,289000,25850,9
372944,Chảo Nướng Chống Dính Kova Vuông HGS,KOVA,347000,Hàn Quốc,Nồi và chảo,450000,103000,23
135273281,Màng bọc thực phẩm Laspalm chính hãng có dao nhựa Moriitalia MBTP00006026,Laspalms,174000,Việt Nam,Phụ kiện nhà bếp,335500,161500,48
137672398,"Combo 3 Khăn lau đa năng Scotch-Brite 3M 30x30cm không gây trầy xước, thấm hút nước gấp 5 lần, không để lại bụi",3M,50000,Việt Nam,Phụ kiện nhà bếp,58000,8000,14
275223334,"Khay Đựng Đồ Dán Tường Nhà Tắm Nhựa Việt Nhật Chất Liệu Nhựa PP An toàn , Siêu Bền - Hàng Việt Nam",Việt Nhật,39000,Việt Nam,,78000,39000,50
54087933,Pin AA Energizer Max E91 BP2,Energizer,52200,Singapore,Pin và dụng cụ sạc pin,52200,0,0
247763372,Máng đi dây điện cho bàn iCockpit,iCockpit,94000,HK/TQ,"Nội thất phòng học, làm việc",180000,86000,48
271064631,Dụng cụ gọt vỏ rau củ trái cây và bào sợi Lafonte - 003636,La Fonte,45500,Trung Quốc,Phụ kiện nhà bếp,91000,45500,50
195470662,"Combo 10 Keo Nến Silicon Làm Thủ Công, Trang Trí (Loại Lớn/Nhỏ)",NAVIVU,29000,Trung Quốc,Dụng cụ sửa chữa nhà cửa,29000,0,0
85029095,Đèn ngủ cảm biến LED Điện Quang ĐQ LNL10 (Cảm biến quang),Điện Quang,38800,Việt Nam,Đèn ngủ,51679,12879,25
133207431,Hộp Muối Dưa Cà - Ngâm Hoa Quả Lock&Lock INL412,LocknLock,67000,Việt Nam,Dụng cụ chứa đựng thực phẩm,109000,42000,39
198198429,10 Bóng đèn Led 1w quả trái chanh bup tròn đui E27 màu sắc lựa chọn trang trí ngoài trời AC220V Posson LL-x,Posson,45000,Việt Nam,Bóng và linh kiện đèn,65000,20000,31
272318899,Ổ cắm chuyển đổi 3 chấu sang 2 chấu - Hàng chính hãng,FuNu,24500,Trung Quốc,"Ổ cắm, ổn áp, biến áp",25000,500,2
100203021,Bộ 10 Đôi Đũa Gỗ Quý Cao Cấp TOKDODO,TOK DO DO TOKDODO TOK DO DO,27900,Việt Nam,"Đũa, muỗng, nĩa",27900,0,0
247763306,"Đèn bắt muỗi, máy bắt muỗi Lebenlang LBL2308, máy diệt côn trùng thông minh 2 tần số, 8W an toàn cho cả gia đình - hàng chính hãng",Lebenlang,769000,Trung Quốc,,1199000,430000,36
120339512,Khăn Tắm Xuất Nhật,fofaHome,11000,Trung Quốc,Khăn,15000,4000,27
167732668,Hộp Nhựa Đựng Bông Tẩy Trang Dạng Ống PaKaSa - Hàng Chính Hãng,PaKaSa,59000,Trung Quốc,Nội thất phòng ngủ,118000,59000,50
50254577,Thước Đo Khoảng Cách Bằng Tia Laser SNDWAY Phạm Vi 50m SW-M50 Cao Cấp AZONE,SNDWAY,350000,Trung Quốc,Thiết bị đo lường,350000,0,0
49116420,"Bút thử nước TDS, dụng cụ đo TDS, máy đo độ cứng của nước",SMY,94000,Trung Quốc,Thiết bị đo lường,159000,65000,41
89198232,Kệ Gia Vị Để Bàn Nora Cho Phòng Bếp Gọn Gàng - GM04,IGA,146000,Việt Nam,,146000,0,0
198199773,Gối cao su em bé Liên Á Oval + kèm áo gối cũng kích thước,Liên Á,191000,Việt Nam,"Gối, ruột gối, vỏ gối",213000,22000,10
275410612,Bộ 2 cuộn túi hút chân không cao cấp 1 mặt nhám - cuộn dài 5m (có nhiều size kích thước khác nhau) - Hàng chính hãng,PaKaSa,107100,Việt Nam/Ấn Độ/Trung Quốc (Tùy từng đợt nhập hàng),Dụng cụ chứa đựng thực phẩm,168000,60900,36
64700139,Bộ Chăn Ga Gối Cotton Tici Đơn Sắc LIDACO - Màu Be,LIDACO,259000,Việt Nam,,350000,91000,26
184903622,Combo 3 bóng Philips LED bulb Essential E27 11W ánh sáng trắng 6500K,Philips,145600,Trung Quốc,Bóng và linh kiện đèn,342000,196400,57
34500805,Móc treo quần áo 7 chấu inox 304 Kibath MS-GNL,KIBATH,250000,Việt Nam,Phụ kiện giặt ủi,250000,0,0
274597284,Hộp Nhựa Chia Thuốc 7 Ngăn - Giao Màu Ngẫu Nhiên,PaKaSa,19000,Trung Quốc,Nội thất phòng ngủ,38000,19000,50
121169152,Túi Giấy Lọc Cà Phê Hario V60 Coffee Paper Filter Loại 2 Ly,Hario,57240,Nhật Bản,"Bình, ly uống cà phê và phụ kiện",57240,0,0
169619846,Vòi hoa sen cầm tay 5 chế độ inox 304 có dây sen Hobby Home Decor BST1,Hobby Home Decor,274550,Trung Quốc,Thiết bị phòng tắm,289000,14450,5
153066085,Pin CR2032 Lithium 3V Maxell cao cấp Made In Japan - Hàng chính hãng,Maxell,30000,Nhật Bản,Pin và dụng cụ sạc pin,30000,0,0
10729838,"Bút thử điện Điện Quang ĐQ ETP01 RB (hiển thị LCD, đỏ đen)",Điện Quang,55700,,Thiết bị đo lường,74158,18458,25
372849,"Bình Ngâm Rượu, Nước Hoa Quả Kova BNR2.7 2.7 Lít",KOVA,169000,Hàn Quốc,,219000,50000,23
53599746,"Combo Giá Treo Ổ Cắm Điện, Modem Dán Tường Tiện Dụng",OEM,32000,Trung Quốc,,32000,0,0
193222347,"Nhang Trầm Hương MỘC LÂM 29cm 500cây, Nhang Sạch Ít Khói Ít Tàn, Hương Dịu Nhẹ, Nhang Phòng Máy Lạnh",mộc lâm,139590,Việt Nam,,148500,8910,6
22165646,Khăn Trải Bàn PAULEE WLG 751 hoa văn phủ nhũ vàng (90 x 150 cm),PAULEE,148000,Đài Loan,Phụ kiện phòng ăn,155000,7000,5
573823,Thiết Bị Đuổi Muỗi Và Đuổi Côn Trùng Tavana PR-001,Tavana,93100,Trung Quốc,"Dụng cụ diệt chuột, côn trùng",95000,1900,2
116199028,"Đệm ngồi 3D Silicon văn phòng PEAFLO thế hệ mới, cấu trúc tổ ong 2 lớp thoáng khí, giảm áp lực lên mông, giảm đau mông.",PEAFLO,132300,Trung Quốc,Nội thất phòng khách,135000,2700,2
191825303,"Ca Ăn Mì , Ca Đựng Cháo Giữ Nhiệt, Tô khuấy Bột Ăn Dặm Cho Bé Hình Vịt Vàng Đáng Yêu - Chính Hãng",PaKaSa,49000,Trung Quốc,Bình/ Ly giữ nhiệt,98000,49000,50
184334157,"Đèn Học , Đèn Đọc Sách Để Bàn Chống Cận Có Ống Đựng Bút , Giá Đỡ Điện Thoại , Cổng Sạc Usb - Hàng Chính Hãng",PaKaSa,267750,Trung Quốc,Đèn học và đọc sách,370000,102250,28
197822149,"Tựa lưng công thái học EMA cho ghế văn phòng, ô tô - Chuẩn công thái học, thoái mái & thoáng mát",Ema,339000,Trung Quốc,"Nội thất phòng học, làm việc",678000,339000,50
272361778,Bình giữ nhiệt Tiger MCX-A602 - HÀNG CHÍNH HÃNG,Tiger,345000,Việt Nam,Bình/ Ly giữ nhiệt,345000,0,0
56736495,"Ổ cắm hẹn giờ ĐQ ESK DT08 W 13 (Điều chỉnh điện tử, 1 lỗ - 3 chấu, trắng)",Điện Quang,205000,Việt Nam,"Ổ cắm, ổn áp, biến áp",266673,61673,23
75697779,Kệ chén đa năng gác trên bồn rửa chén 6 ngăn inox 304 Hobby Home Decor KC6N co giãn bề ngang không rỉ sét,Hobby Home Decor,1047850,Trung Quốc,,1103000,55150,5
274324195,"Set 10 Miếng Cọ Rửa Lưới Chén Bát, Nồi, Chảo, Lau Bếp Chống Xước ",PEAFLO,39000,Thái Lan / Trung Quốc / Malaysia (Tùy từng đợt nhập hàng),Phụ kiện nhà bếp,45000,6000,13
190703519,"Giỏ treo hoa ban công, D22xC18cm, chất liệu sắt sơn tĩnh điện, phù hợp với mọi lan can |Greenhome",Greenhome,38900,Việt Nam,"Hoa tươi, Cây cảnh & Hạt giống",62820,23920,38
73589647,Combo 50 cái Tô bã mía Thái Lan 875ml,Gracz,149000,Thái Lan,Phụ kiện nhà bếp,149000,0,0
174299634,Giá Treo Bàn Chải Nhà Tắm OENON - Bộ nhả kem đánh răng tự động kèm cốc và miếng dán tường - OEKEM,OENON,99000,Trung Quốc,,190000,91000,48
195656261,"Hạt Giống Rau Tía Tô Greenhome, Gói 2gr, Dễ Trồng Quanh Năm, Nảy Mầm Cao, Thu Hoạch Nhanh, Năng Suất Cao G05",SENVANG SEEDS,11900,Việt Nam,"Hoa tươi, Cây cảnh & Hạt giống",17820,5920,33
711508,Chuông Cửa Đơn Không Dây Tavana DB-001 - Trắng,Tavana,132300,Trung Quốc,Bảo vệ nhà cửa,135000,2700,2
88925284,Ổ Cắm Điện LIOA 10 ổ dây 3m(4D6S32) & 5m (4D6S52),LiOA,152000,Việt Nam,"Ổ cắm, ổn áp, biến áp",152000,0,0
263085492,Khay Inox Úp Ly Có Lỗ - Mâm Trà Chữ Nhật Nhiều Cỡ,TOK DO DO TOKDODO TOK DO DO,45000,China / Vietnam,Phụ kiện phòng ăn,45000,0,0
271064522,Dụng cụ nghiền khoai tây không dính Lafonte - 003568,La Fonte,72300,Trung Quốc,Phụ kiện nhà bếp,142000,69700,49
273938685,"Giấy lọc cà phê Hario Pegasus 100 cái PEF-02-100M 2-4 cups, màu tự nhiên",Hario,63000,Nhật Bản,"Bình, ly uống cà phê và phụ kiện",69000,6000,9
135442429,Kìm Bấm Lỗ 9 Inch Deli Tools Màu Đen Cao Cấp - Kích Thước Lỗ Bấm Đa Dạng Phù Hợp Với Nhiều Nhu Cầu Khác Nhau - DL1919,Deli,69000,Trung Quốc,Dụng cụ sửa chữa nhà cửa,124200,55200,44
202215302,Chăn sofa | JYSK Daglilje | polyester | nhiều màu | R130xD170cm,JYSK,189000,Trung Quốc,"Chăn, mền và phụ kiện",199000,10000,5
275075556,Giỏ tròn đựng đồ tiện lợi My Laundry không thấm nước,Nhà của Mẹ,161500,China / Vietnam,Phụ kiện giặt ủi,170000,8500,5
193716916,Bình chữa cháy xách tay Tomoken Bột ABC 4kg có kiểm định,Tomoken,395000,Việt Nam,Bảo vệ nhà cửa,520000,125000,24
56449571,"KỆ GỖ GÓC TƯỜNG ĐA NĂNG, KỆ TRANG TRÍ 4 TẦNG CAO 1.2M GỖ CAO SU TỰ NHIÊN ",OEM,135000,Việt Nam,Nội thất phòng khách,135000,0,0
198462337,Combo10 Đầu nối dây điện nhanh cút zắc cầu đấu kẹp nhanh 2 pha FC-2,Posson,11000,Việt Nam,Bóng và linh kiện đèn,19000,8000,42
111843864,"Đệm ngồi 3D Silicon EMA thế hệ 3 cao cấp - Cấu trúc tổ ong thông minh - Chống đau mỏi trĩ, xương cụt, thâm mông, xệ mông cho dân văn phòng, lái xe, sinh viên",Ema,150000,Trung Quốc,Nội thất phòng khách,300000,150000,50
58456783,100 LY GIẤY TRẮNG DÙNG 1 LẦN 200ml,OEM,29000,Malaysia,Phụ kiện nhà bếp,50099,21099,42
7654183,Phân bón hữu cơ đậm đặc Đầu Trâu AGRIMARTIN SUPER ORGANIC (gói 1kg),Bình Điền Mekong,40560,,"Hoa tươi, Cây cảnh & Hạt giống",40560,0,0
271556487,Móc Inox Dán Tường Chịu Lực 10KG Móc Treo Đồ Nặng Dán Tường Chất Lượng Cao,PEAFLO,49000,HK/TQ,,75000,26000,35
194005519,"Ghế Kê Chân Văn Phòng, Chịu lực 200 kg Plyconcept Seiza Chair - Gỗ Uốn Cong",Plyconcept,159000,Việt Nam,Nội thất phòng khách,280000,121000,43
116021584,"Phân Bón Hoa Hồng SOYMIC PMP Siêu Phân Bón Ủ Vi Sinh Từ Đậu Nành, Trứng, Chuối, Humic, Vi Lượng 1000ml",PMP,120000,Việt Nam,"Hoa tươi, Cây cảnh & Hạt giống",125000,5000,4
70767745,[21 màu] Hộp 30 cây nến taper Eden Candle FTRAMART EDC2324 cao 11 cm (Lựa chọn màu),Miss Candle,78000,Việt Nam,Trang trí nhà cửa khác,135000,57000,42
194023564,Thùng rác nhựa KENZIO 60 lít CHÂN ĐẠP,KENZIO,290000,"Việt Nam / Hàn Quốc / Ấn Độ / Trung Quốc,...",Dụng cụ vệ sinh,290000,0,0
5719115,Bộ Giữ Ấm Bình Trà Trái Dừa,Vỏ bình trà,289000,Việt Nam,"Bình, ly uống trà và phụ kiện",289000,0,0
231262233,Dụng cụ ăn cua ghẹ - Bóc tách vỏ tôm - Dao tách hàu - Kẹp mở sò siêu nhanh,Song An Eco,34000,Việt Nam,Phụ kiện nhà bếp,34000,0,0
15512308,Hệ thống tưới nhỏ giọt 20 chậu và đầy đủ phụ kiện,OEM,159000,HK/TQ,Dụng cụ làm vườn,159000,0,0
248654893,"Dụng Cụ Băm Rau Củ Quả , Xay Tỏi Ớt , Xay Thịt Cầm Tay DAMAS Quick Chopper A397 - Hàng chính hãng",Damas,128250,Hàn Quốc / Trung Quốc,Phụ kiện nhà bếp,210000,81750,39
273533211,"Combo 6 Túi Hút Chân Không Đựng Chăn Màn, Quần Áo, Chống Ẩm Mốc Bụi, Bảo Quản Quần Áo Chăn Gối Mền - TẶNG KÈM BƠM ĐIỆN - HÀNG CHÍNH HÃNG MINIIN",MINIIN,146300,Trung Quốc,Phụ kiện phòng ngủ,199000,52700,26
69754010,"Keo dán Đa Năng Nhật Bản Dán thủy tinh, bê tông, gạch, đá, gỗ , nhựa cứng ULTRA SU HARD (CỨNG) 10ml #05140, chống thấm nước  (Hàng nội địa Nhật)",KONISHI,117810,Nhật Bản,Dụng cụ sửa chữa nhà cửa,138600,20790,15
156655718,Combo 4 Ống Hút Inox 304 Kèm Cọ Rửa - Hàng Loại 1 - Chính Hãng MINIIN,MINIIN,39000,Việt Nam,Phụ kiện phòng ăn,39000,0,0
102076973,"Ô thẳng cao cấp tán rộng Nason Gentle - Dù thẳng cao cấp Nason - Ô dù chống lật, ô thẳng che mưa",Nason Umbrella,332500,Trung Quốc,"Áo mưa, ô dù và phụ kiện đi mưa",500000,167500,34
191628537,"Sơn xịt phản quang màu sắc tươi sáng đủ màu Redfox - sơn xe máy, ô tô, mâm xe",Bosny,35000,Thái Lan,"Sơn, dầu mỡ, hóa chất",35000,0,0
275830252,Bộ nồi chiên nhúng ngập dầu inox304 cao cấp có tay cầm tiện dụng 26.3x12cm (Tặng kèm 1 món quà tri ân)- Hàng chính hãng,KINGO,125000,China,Phụ kiện nhà bếp,175000,50000,29
206485076,Hương nhang sạch Dương Minh nhang 20cm và 30cm 100% thành phần tự nhiên các loại nhang Cam Sả nhang Bồ Kết nhang Bắc nhang Thảo Mộc nhang Quế nhang Khuynh Diệp và Trầm Hương cao cấp,Dương Minh Since 1984,42000,Việt Nam,,55000,13000,24
200875220,Kệ Để Đựng Đồ Đa Năng 4 Tầng - Thanh Inox - Giá Nhựa có lỗ Cao cấp[CÓ BÁNH XE] màu trắng - Hàng Loại 1 - Chính Hãng MINIIN,MINIIN,82000,Trung Quốc,,99000,17000,17
225175166,"Dụng cụ mài dao kéo KGZ08 đa năng cực sắc bén dễ sử dụng, tốc độ nhanh tiện lợi (màu ngẫu nhiên) 3rãnh- Hàng chính hãng",KINGO,33000,Việt Nam,"Dao, kéo và phụ kiện",65000,32000,49
190510339,"Lưới làm giàn cây leo,, Độ bền cao, Dễ lắp đặt, Không viền, Làm giàn bầu, Mướp, bầu, Bí, hoa, Nhiều kích thước |Greenhome",Greenhome,29000,Việt Nam,,50000,21000,42
165167046,"Dao Chặt Xương, Chặt Thịt Gà Seki - Hàng Chính Hãng",PEAFLO,239000,Nhật Bản / Trung Quốc,"Dao, kéo và phụ kiện",320000,81000,25
59358362,"Màn chụp võng FUNU, chống muỗi, côn trùng khi ngủ võng cho bé, người lớn - Hàng chính hãng",FuNu,65000,Việt Nam,Phụ kiện phòng ngủ,65000,0,0
451856,Cáp nối dài Điện Quang ĐQ EPF 5W.2PN dây dài 5m (Giao màu ngẫu nhiên),Điện Quang,65800,Việt Nam,Phụ kiện nhạc cụ,87732,21932,25
85029571,Set 5 Phích cắm công suất lớn Điện Quang ECO ĐQ EPR HP 2PN ECO (Màu ngẫu nhiên),Điện Quang,46008,Việt Nam,"Ổ cắm, ổn áp, biến áp",60400,14392,24
42905349,Dây Đèn Trang Trí Lung Linh 10m 100 bóng đầu ghim cao cấp,OEM,77000,Trung Quốc,,77000,0,0
84983190,Combo 4 móc treo đồ dán tường inox 304 sơn đen Hobby Home Decor 160D-4,Hobby Home Decor,125000,Trung Quốc,,235000,110000,47
56304066,Kệ để dao kéo nhà bếp inox 304 có khay hứng nước Hobby Home Decor DD25,Hobby Home Decor,192850,Trung Quốc,"Dao, kéo và phụ kiện",299000,106150,36
272987515,"Dầu Neem Oil Sinh Học Greenhome, Neem Chill, 150ml, Kết Hợp Tinh Dầu Tỏi, Ớt, Trừ Bọ Trĩ, Nhện Đỏ, Rầy, Rệp Sáp Cho Cây",ĐIỀN TRANG - NEEM,62900,Việt Nam,"Hoa tươi, Cây cảnh & Hạt giống",90000,27100,30
271064516,Bình giữ nhiệt Lafonte 180695 500ml,La Fonte,115000,Trung Quốc,Bình/ Ly giữ nhiệt,226000,111000,49
275079710,Kệ Giày Dép 4 Tầng Khung Inox Chắc Chắn - Hàng chính hãng ( Hoa văn giao ngẫu nhiên),Gro-Fa,79000,Trung Quốc,Nội thất phòng khách,79000,0,0
190755142,"Hạt Giống Rau Mồng Tơi Greenhome, Gói 20g, Dễ Trồng Quanh Năm, Nảy Mầm Cao, Thu Hoạch Nhanh, Năng Suất Cao R11",SENVANG SEEDS,17900,Việt Nam,"Hoa tươi, Cây cảnh & Hạt giống",30000,12100,40
157569314,Rổ Nhựa Đa Dụng Inomata Có Lỗ Thoáng Khí Nhiều Size,Inomata,40000,Nhật Bản,Dụng cụ chứa đựng thực phẩm,40000,0,0
4361879,Bộ lọc nước thô đầu nguồn 3 cấp lọc 10inch Yamato YMTH10-3T,YAMATO,374000,Việt Nam,"Bình lọc, lõi lọc, thiết bị lọc nước",450000,76000,17
98701140,B4 - 20cm x 25m -Cuộn Bong Bóng Khí - Màng xốp hơi - Xốp nổ - gói hàng,MAGIX,36400,Việt Nam,Ngoại thất sân vườn,36400,0,0
271382154,"Đèn Ngủ Cảm Ứng Thông Minh Sử Dụng Pin Sạc FEIDASH TB-38SL - Cảm Ứng Nhạy Bén Khi Có Chuyển Động - Chiếu Sáng Đa Chức Năng, Có Thể Cầm Tay Sử Dụng Như Đèn Pin - Sạc Bằng Cáp Sạc USB-C Và Sạc Không Dây Qua Đốc Sạc Adapter ",feidash,239000,Trung Quốc,Đèn ngủ,500000,261000,52
106633540,"Chuông Cửa Không Dây Thông Minh Besti BT-01, Chống Nước, Khoảng Cách Sử Dụng Trong 300M, 36 Loại Nhạc - Hàng Chính Hãng ",Besti,170000,Trung Quốc,Bảo vệ nhà cửa,170000,0,0
190755084,"Hạt Giống Rau Xà Lách Vàng Greenhome, Gói 10g, Dễ Trồng Quanh Năm, Nảy Mầm Cao, Thu Hoạch Nhanh, Năng Suất Cao R13",SENVANG SEEDS,10900,Việt Nam,"Hoa tươi, Cây cảnh & Hạt giống",17820,6920,39
117070232,"Đèn Tròn Livestream 26cm 10inch, Không Kèm Chân - Hàng Chính Hãng",Essesa,90250,Trung Quốc,,95000,4750,5
55455923,Hạt giống khổ qua giống khỏe năng suất cao VTS25,Sen Vàng Seeds,13312,Việt Nam,"Hoa tươi, Cây cảnh & Hạt giống",13312,0,0
243097304,Bán lẻ bộ bát đĩa chén đĩa cao cấp họa tiết sọc màu trắng xám men sáng đẹp,GOSU,20000,Trung Quốc,"Tô, chén, dĩa",35000,15000,43
115748143,Mành Tre ONGTRE làm Cơm cuộn (Kimbap) Hàn Quốc | ongtre (Vietnam),ongtre,54000,Việt Nam,Phụ kiện nhà bếp,54000,0,0
275297428,Bộ Tua Vít Bỏ Túi Đa Năng 24 Món - Tô Vít Sửa Chữa Mở Điện Thoại Vi Tính cao cấp DRU - Hàng Chính Hãng,DRU,96000,Trung Quốc,Các loại máy và phụ kiện,96000,0,0
249029020,"Bộ Đầu Bơm Hút Dầu Rửa Bát Gắn Bồn Rửa, Vòi Hút Xà Bông Nước Rửa Chén Tiện Lợi Có Ống Silicon Dài 1.2 Mét - HÀNG CHÍNH HÃNG MINIIN",MINIIN,87000,Trung Quốc,Phụ kiện nhà bếp,99000,12000,12
176663434,Set 2 chai tinh dầu refill máy khử mùi thơm phòng cảm biến Glade 18mL Nhật Bản,Glade,225000,Nhật Bản,"Đèn xông tinh dầu, tinh dầu và phụ kiện",225000,0,0
108091670,"Bộ Sản Phẩm Ống Hút,Muỗng,Đũa Kèm Cây Vệ Sinh Ống Hút BaoAn- Có 2 Mẫu Để Lựa Chọn - Giao Màu Ngẫu Nhiên - Hàng Chính Hãng",BaoAn,51350,Việt Nam,"Đũa, muỗng, nĩa",79000,27650,35
20825742,"Combo 30 Đồng Xu Cổ Phong Thủy Âm Dương Bằng Đồng Kim Tiền Jewelry - Đường Kính 2,4 cm - Tặng Kèm Túi Gấm Đỏ",Kim Tiền Jewelry,120000,,Vật phẩm phong thủy,120000,0,0
16341786,Bình Giữ Nhiệt Lock&Lock LHC1439 Dung Tích 1000ml,LocknLock,298000,,Bình/ Ly giữ nhiệt,542000,244000,45
73529777,"Kệ chén bát đa năng bằng thép carbon không gỉ, chống xước, sơn đen tĩnh điện, giá bát trên bồn rửa ráo nước cho nhà bếp sạch sẽ VANDO",VANDO,299000,Trung Quốc,,349000,50000,14
201566005,Ly nhựa 2 lớp LocknLock kèm ống hút Dream star Double wall cold cup 750ml HAP522,LocknLock,120000,Trung Quốc,"Ly, cốc & phụ kiện ly",217000,97000,45
73887002,Đèn Ngủ Cảm Ứng Cảm Biến Dán Tường Sạc Pin USB Đời Mới,OEM,80000,Trung Quốc,,80000,0,0
274080704,"Hộp Cơm Giữ Nhiệt, Ủ Cháo Lock&Lock LHC8053NVY (500ml ) LHC8052NVY (300ml) - Hàng Chính Hãng",Lock&Lock,480000,Trung Quốc,Bộ hộp cơm và phụ kiện,480000,0,0
116048764,Kệ sách tổ ong vân gỗ dễ dàng kết hợp với bàn làm việc chính hãng IGA - GP100,IGA,188000,Việt Nam,"Nội thất phòng học, làm việc",188000,0,0
92453371,"Áo Mưa Cánh Dơi Có Kiếng Đèn, Áo Mưa Kiếng Đèn Vải Dù Loại Siêu Dày, Hàng Việt Nam, Khổ To Rộng, Chống Thấm Hiệu Quả, Phù Hợp Nam Và Nữ, Có Túi Đựng, Có Lựa Chọn Màu Sắc",XUDI,130000,Việt Nam,"Áo mưa, ô dù và phụ kiện đi mưa",130000,0,0
219457489,"Đèn led KG62 tích điện năng lượng mặt trời siêu sáng, ánh sáng trắng có remote điều khiển và tấm pin năng lượng mặt trời / thích hợp đi vườn, cắm trại, picnic , khi nhà cúp điện 120w- Hàng chính hãng",KINGO,134000,China / Vietnam,Đèn ngoài trời,155000,21000,14
101894776,"Bóng bulb trụ PHILIPS Tforce Core G3 (Thế hệ mới)- Hi Lumen (22W,30W,40W,50W)",Philips,203500,Trung Quốc,Bóng và linh kiện đèn,430500,227000,53
249829748,Ly Giữ Nhiệt Inox 304 Iced Americano 600ml Kèm Ống Hút,PEALO,79000,HK/TQ,Bình/ Ly giữ nhiệt,79000,0,0
181909432,Chảo Suit LocknLock CSU1243PIK - Màu Pink,LocknLock,377000,Trung Quốc,Nồi và chảo,709000,332000,47
7202377,Bộ 3 Lõi Lọc Nước Máy Tiêu Chuẩn Barrier,BARRIER,509000,Nga,"Bình lọc, lõi lọc, thiết bị lọc nước",660000,151000,23
163398765,Chân Kệ Tủ Lạnh Máy Giặt  Tủ Lạnh Chống Rung Lắc Khung Inox Đế Nhựa Có Điều Chỉnh Kích Thước - Chịu Lực Lên Đến 300Kg - Hàng Chuẩn Loại  1 - MINIIN,MINIIN,99000,China / Vietnam,,99000,0,0
247681305,"Đầu Vòi Sen Lọc Nước Lock&Lock 80mm CLR-KR LBW400 (Mạch nước nhip nhàng, giảm stress - Khử Clo)",LocknLock,470000,Hàn Quốc,Thiết bị phòng tắm,890000,420000,47
273410799,"Bình Nước Thủy Tinh Cao Cấp Bọc Da Mitomo, Chịu Lực, Chịu Nhiệt, Có Dây Đeo Kèm Bộ Lọc Inox 304 Dung Tích 500ML hàng chính hãng",Mitomo,86000,Trung Quốc,,154000,68000,44
176731837,Sọt Đựng Rác Tiện Lợi Nhiều Cỡ Hiro Hàng Xuất Nhật Inochi - Hàng Chính Hãng ( Tặng kèm khăn lau đa năng) Giao màu ngẫu nhiên,Inochi,60000,Việt Nam,Dụng cụ vệ sinh,60000,0,0
275451443,Chảo chống dính vân đá Elmich EL-4711OL,Elmich,205200,Việt Nam,Nồi và chảo,365000,159800,44
207196788,Combo 2 Cuộn ron gioăng mút xốp dán khe khung cửa cách âm giảm chấn chống bụi dài 2 mét,Legaxi,31000,Trung Quốc,Dụng cụ sửa chữa nhà cửa,31000,0,0
275495218,"Bánh Xe Đẩy Hàng Có Bạc Đạn Và Khóa ANKAN, Bánh Xe Nhựa PVC Mini 40mm",ANKAN,12800,Việt Nam/ Trung Quốc/ Đức,Xe đẩy hàng,20000,7200,36
73113608,Bình PET Đựng Nước Tròn Có Vòi 10 Lít Duy Tân thân bình trong suốt giao quai màu ngẫu nhiên (Ø 20 x 40.2 cm) No.625 ,Duy Tân,68000,Việt Nam,,68000,0,0
251520141,Giá Treo Quần Áo Cao Cấp- Giá Treo Đồ Đứng Nội Thất Kiểu Hàn - Màu Gỗ Tự Nhiên,GACCO,530000,Việt Nam,Nội thất phòng khách,530000,0,0
19915578,Muỗng canh DandiHome Inox 304,DandiHome,92400,Việt Nam,"Đũa, muỗng, nĩa",92400,0,0
3677765,Bình Lọc Nước BRITA Marella XL Blue - 3.5L (Kèm Maxtra Plus),Brita,939550,Trung Quốc,"Bình lọc, lõi lọc, thiết bị lọc nước",1649000,709450,43
146887829,"Đèn Pixar, Đèn Bàn Học Chống Cận Thị, Đèn Đọc Sách LED, Đèn Làm Việc Bảo Vệ Mắt, đèn học để bàn, đèn học cho học sinh sinh viên, đèn trang trí decor - Hàng Chính Hãng dododios",dododios,173000,China,Đèn học và đọc sách,173000,0,0
260860844,Kệ chén đĩa bát có nắp đậy 2 tầng sạch sẽ chống bụi cho nhà bếp tiện lợi,VANDO,849000,Trung Quốc,,1699000,850000,50
274801567,Bộ Đũa Muỗng Nĩa Kèm Hộp Lúa Mạch PaKaSa - Hàng Chính Hãng (giao màu ngẫu nhiên),PaKaSa,39000,Trung Quốc,,78000,39000,50
253350489,Ổ cắm điện Điện Quang cao cấp 4 lỗ 3 chấu - 4 công tắc riêng - dây dài 2m/5m ĐQ ESK SM740SL Chịu tải cao 2500W,Điện Quang,145000,Việt Nam,"Ổ cắm, ổn áp, biến áp",145000,0,0
135442409,Đồng hồ vạn năng Deli chính hãng - Màn hình LED kỹ thuật số - Phạm vi đo 600V - Hàng chính hãng - DL8490,Deli,199000,Trung Quốc,Thiết bị đo lường,358200,159200,44
131407909,Bàn làm việc bàn học bàn máy tính kệ lửng,HG FURNITURE H i G,352750,Việt Nam,"Nội thất phòng học, làm việc",352750,0,0
275212583,"Bình Nước Thể Thao HOKORI, Nhựa PP Nguyên Sinh , Chịu Được Nhiệt Độ Cao, Dung Tích 700ml, An Toàn Cho Sức Khoẻ - Hàng chính hãng",Hokori,99000,Trung Quốc,,99000,0,0
274461464,"Áo mưa bít vải dù cao cấp kín người ,(áo mưa chui ) chống thấm nước ,cho người lớn ,nhiều màu sắc tươi trẻ , phù hợp cả nam và nữ",XUDI,131000,Việt Nam,"Áo mưa, ô dù và phụ kiện đi mưa",139000,8000,6
263443855,Móc Gỗ Dán Tường Treo Đồ Kèm Keo 2 Mặt,NAVIVU,35000,Trung Quốc,,35000,0,0
44335150,"Kéo Bếp Đa Năng, Kéo Cắt Thịt Gà Vịt",OEM,96900,Trung Quốc,"Dao, kéo và phụ kiện",102000,5100,5
272227021,Kệ để màn hình máy tính decor bàn làm việc gỗ MDF phủ melamin chống xước thương hiệu IGA - GA28,IGA,89000,Việt Nam,"Nội thất phòng học, làm việc",89000,0,0
580040,Chảo Đá Chống Dính Siêu Bền Sunhouse SBD24 24cm,Sunhouse,220000,Việt Nam,Nồi và chảo,320000,100000,31
275870032,"Kệ Máy Tính Gỗ Để Bàn FIVO FB25 Gỗ Dày Chống Ẩm, Gọn Gàng Góc Làm Việc, Nâng Chiều Cao Màn Hình, Bảo Vệ Đốt Sống Cổ",FIVO,121000,Việt Nam,"Nội thất phòng học, làm việc",126000,5000,4
275105847,"Bầu Chiết Cành Greenhome, Dụng Cụ Làm Vườn, Tăng Khả Năng Ra Rễ, Chống Úng Cành Chiết, Độ Bền Đến 2 Năm, Dễ Sử Dụng",Greenhome,2100,Việt Nam,"Hoa tươi, Cây cảnh & Hạt giống",4000,1900,48
273984047,Dụng Cụ Chặn Cửa Chèn Cửa KUNBE Chất Liệu Cao Su Bo Kim Loại Chống Va Đập,KUNBE,63000,Trung Quốc,Bảo vệ nhà cửa,63000,0,0
137753122,Công tắc thông minh ĐIỀU KHIỂN TỪ XA qua wifi HUNONIC DATIC 1 Kênh 500W - Cơ Điện Shop,HUNONIC,99000,Việt Nam,Thiết bị điều khiển thông minh,99000,0,0
196188267,"Aptomat chống giật (bảo vệ quá tải, ngắn mạch & chống dò điện) RCBO DoBo Korea",Dobo,14000,Hàn Quốc,Thiết bị điều khiển thông minh,14000,0,0
204985175,"Keo Ghép Cành Greenhome, Dụng cụ làm vườn, Bảo Vệ Mối Ghép Nhanh Liền, Tự Dính, Tự Huỷ, Dễ Sử Dụng",Greenhome,17900,Việt Nam,"Hoa tươi, Cây cảnh & Hạt giống",32000,14100,44
94188664,Máy sấy giày Xiaomi Sothing Zero Shoes Dryer - Hàng Nhập Khẩu,Xiaomi,279000,Trung Quốc,Phụ kiện giặt ủi,279000,0,0
197649725,Bình Nước Giữ Nhiệt 500ml Bằng Thép Không Gỉ 304 Hai Lớp Có Màn Hình Kỹ Thuật Số Hiển Thị Nhiệt Độ Cảm Biến 1 Chạm,NBAYOU,125000,Việt Nam,Bình/ Ly giữ nhiệt,125000,0,0
180105523,"Nệm cao su non Thắng Lợi, Đệm cao su tổng hợp GẤP 3 hàng chính hãng bảo hành 15 năm",Nệm Thắng Lợi,1100000,Việt Nam,Nệm và phụ kiện,1100000,0,0
275575764,"Kệ Sách Gỗ Mini Để Bàn FIVO FB27 Đa Năng, Dễ Lắp Ráp, Tiết Kiệm Không Gian, Gọn Gàng Góc Học Tập Và Làm Việc",FIVO,114000,Việt Nam,"Nội thất phòng học, làm việc",179000,65000,36
198246045,"Đèn Pin Mini Cầm Tay Siêu Sáng US ARMY K2, Tầm Sáng 300m Chống Nước Tuyệt Đối Công Suất 20W Dung Lượng Pin 5800mAh Có Thể Sạc Lại Full Box -HÀNG CHÍNH HÃNG",US ARMY,150000,Hàn Quốc / Trung Quốc,,300000,150000,50
270114393,"Bơm tăng áp dùng cho vòi sen, máy giặt Vinetteam - Bơm tăng áp trợ lực nguồn DC24V - hàng chính hãng",VINETTEAM,650000,Trung Quốc,"Máy bơm, máy cắt cỏ",650000,0,0
274731679,Bộ Hộp Cơm Giữ Nhiệt 2GOOD Lunch Box HC02 - hàng chính hãng,2Good,590000,Trung Quốc,Dụng cụ chứa đựng thực phẩm,590000,0,0
690393,Bộ 2 Giấy Không Thấm Dầu / Giấy Nướng Bánh Goodbake GB30 (30cm x 5m),Goodbake,42000,Việt Nam,Dụng cụ làm bánh,42000,0,0
148801631,Cân Tiểu Ly Điện Tử Nhà Bếp Định Lượng 3000g - 0.1g  Cân Làm Bánh Có Độ Chính Xác Cao - Hàng Chính Hãng MINIIN,MINIIN,199000,China / Vietnam,Dụng cụ làm bánh,199000,0,0
273661002,Bình giữ nhiệt inox 316 Elmich EL8315 dung tích 480ml - Hàng Chính Hãng,Elmich,202350,Trung Quốc,Bình/ Ly giữ nhiệt,470000,267650,57
686905,Hộp Thủy Tinh Tròn Glasslock MCCB205 (2000ml),GlassLock,177000,Hàn Quốc,Dụng cụ chứa đựng thực phẩm,419000,242000,58
754592,Ổ Cắm Điện 3D + 3S Dây 3m x 2 Lioa 3D3S32 - Đen,LiOA,113000,Việt Nam,"Ổ cắm, ổn áp, biến áp",113000,0,0
191314447,"Bình giữ nhiệt Lock&Lock 505ml Maman Cup Vacuum Bottle LHC1487 - Hàng chính hãng, nắp dùng làm cốc nước uống - JoyMall",LocknLock,283200,Hàn Quốc / Trung Quốc,Bình/ Ly giữ nhiệt,515000,231800,45
73829601,"Kệ Sách Thông Minh Kệ Sách Để Sàn Cao Cấp 11 Tầng, Gỗ MDF Phủ Melamin Chống Nước Chống Xước, Thương Hiệu IGEA",IGA,447000,Việt Nam,"Nội thất phòng học, làm việc",447000,0,0
75627647,Phin Nhôm Pha Cà Phê Cao Cấp,COFFEE TREE,69000,Việt Nam,"Bình, ly uống cà phê và phụ kiện",99000,30000,30
185380220,"Keo quét Nhật Bản - TaiKomi Japan chống thấm vết nứt mái nhà, sàn nhà vệ sinh, máng xối, tôn, triệt để",TAIKOMI,172500,Việt Nam,"Sơn, dầu mỡ, hóa chất",249000,76500,31
270882774,Cây lau nhà tự vắt thông minh MG02,Parroti,257450,Trung Quốc,Dụng cụ lau nhà,271000,13550,5
275346545,Đèn pha năng lượng mặt trời 40W ( vỏ nhựa ),Vạn Năng Solar,269000,Trung Quốc,Đèn ngoài trời,299000,30000,10
130829751,"Combo 12 Hũ Thủy Tinh PEAFLO Làm Caramen, Sữa Chua, Đựng Gia Vị Đa Năng - Giao Ngẫu Nhiên",PEAFLO,51000,Việt Nam,Dụng cụ chứa đựng thực phẩm,65000,14000,22
198057044,Dây Đèn LED Edison S14 Năng Lượng Mặt Trời Chống Nước Trang Trí Ngoài Trời - Chính Hãng NAVIVU,NAVIVU,660000,Trung Quốc,Đèn ngoài trời,660000,0,0
272484839,"Nhiệt ẩm kế, nhiệt kế phòng Deli đồng hồ xem giờ có báo thức đo nhiệt độ phòng, độ ẩm phòng ngủ cho bé chính xác",Deli,139000,Trung Quốc,Thiết bị đo lường,250200,111200,44
130410828,Chăn Ngủ Văn Phòng Chăn Du Lịch Giữ Ấm Màu Trơn Cho Nam Cao Cấp - Kích  Thước(160cm * 120cm)- Hàng Chính Hãng MINIIN,MINIIN,108300,Việt Nam / Thái Lan,"Chăn, mền và phụ kiện",120000,11700,10
275352110,"Xe Đẩy Hàng, Xe Kéo Hàng gấp gọn Anhlamstore trọng lượng lớn 150kg - 300kg",Anh Lam Store,606000,Trung Quốc / Singapore / Việt Nam,Xe đẩy hàng,650000,44000,7
2039747,Bộ Nồi Inox 3 Đáy Sunhouse SH334,Sunhouse,502480,Việt Nam,Nồi và chảo,690000,187520,27
627748,Áo Mưa Rando Easy Trum APPC-10,Rando,82000,Việt Nam,"Áo mưa, ô dù và phụ kiện đi mưa",82000,0,0
7699053,"Nồi Nhôm Chống Dính Lock&Lock Baum Marble 2 Tay Cầm, Nắp Thủy Tinh LBU1202 (20cm)",LocknLock,362000,Trung Quốc,Nồi và chảo,681000,319000,47
3677753,Bình Lọc Nước BRITA Flow Basic Blue - 8.2L (Kèm Maxtra Plus) - Hàng Chính Hãng,Brita,1569000,Trung Quốc,"Bình lọc, lõi lọc, thiết bị lọc nước",2499000,930000,37
275678781,Bộ đổi điện 12v thành 220v 1200W,Nanomax,349000,Trung Quốc,"Ổ cắm, ổn áp, biến áp",349000,0,0
198929840,"Trụ nhựa trồng cây, D20xR6cm, nhựa cứng, có khớp dễ nối dài, chuyên hệ cây leo, trầu bà, kiểng lá |Greenhome",Greenhome,5900,Việt Nam,"Hoa tươi, Cây cảnh & Hạt giống",11000,5100,46
274555496,"Bàn ăn gấp gọn thông minh có bánh xe di chuyển, tiết kiệm diện tích thương hiệu IGA - GM107",IGA,1392000,Việt Nam,Nội thất phòng ăn,1392000,0,0
270504323,Tủ nhựa trẻ em 2 cánh Happy Kids Sunhouse KS-CA1400B4,Sunhouse,1830000,Việt Nam,Nội thất trẻ em,2470000,640000,26
182782186,VÕNG LƯỚI DUY LỢI CỠ ĐẠI,Duy Lợi,449000,Việt Nam,Phụ kiện phòng ngủ,449000,0,0
72894761,"Bình Giữ Nhiệt Lock&Lock Chubby Tumbler LHC3233 370ml - Hàng Chính Hãng, Có Dây Treo, Chất Liệu Thép Không Gỉ, Mở Nắp Bằng 1 Tay",LocknLock,251000,Trung Quốc,Bình/ Ly giữ nhiệt,461000,210000,46
106208918,"Ô dù che mưa cỡ lớn tự động đóng mở, gấp gọn tiện lợi - Thiết kế mở ngược chống ướt khi mở, gập - Chính hãng NIKITA",Nikita,139000,Trung Quốc,"Áo mưa, ô dù và phụ kiện đi mưa",159000,20000,13
253391339,"Bộ xả chậu rửa chén KG35 2 hộc và 1 hộc cao cấp siêu bền thoát nước nhanh sử dụng tốt, ống bằng chất liệu inox sus304 (Tặng kèm 1 món quà tri ân) -Hàng chính hãng",KINGO,285000,Việt Nam,Phụ kiện nhà bếp,350000,65000,19
102060036,Bàn làm việc chân sắt chữ U đơn giản - Thương Hiệu TIDO - Mặt 17mm MDF melamine - Chân sắt hộp tĩnh điện 25x50mm - Thùng full phụ kiện,TIDO,552500,Việt Nam,"Nội thất phòng học, làm việc",650000,97500,15
181773473,"VƯỜN SINH THÁI - Combo Thuốc Trừ Sâu Sinh Học và Trị Nấm Bệnh hại cây trồng NEEM NANO - Khỏi lo sâu, nhện đỏ, rệp sáp, bọ trĩ, rỉ sắt, thán thư, phấn trắng, đốm đen - 100% từ Thiên Nhiên - Không cần cách ly",VƯỜN SINH THÁI,270000,Korea / China / Vietnam,"Hoa tươi, Cây cảnh & Hạt giống",270000,0,0
91165526,"Bình Đựng Nước Lock&Lock Easy Grip Dung Tích 1.2L và 1.5L, Làm Từ Nhựa PET - Hàng Chính Hãng",LocknLock,41000,Việt Nam,,65000,24000,37
275405659,"Miếng ngăn rác và giữ nước bồn rửa chén, lavabo, bồn rửa mặt PaKaSa (giao màu ngẫu nhiên)",PaKaSa,9900,Thái Lan / Trung Quốc / Malaysia (Tùy từng đợt nhập hàng),Thiết bị phòng tắm,18000,8100,45
155186594,"Hộp Đựng Trang Sức, Phụ Kiện Thiết Kế Hiện Đại - Chọn Màu - Hàng Chính Hãng",PaKaSa,255000,Trung Quốc,Phụ kiện phòng ngủ,354000,99000,28
68716605,Dao Làm Bếp Đa Năng Sunhouse KS-KN165KS,Sunhouse,83800,Việt Nam,"Dao, kéo và phụ kiện",117000,33200,28
7013529,Bàn Học Gấp Gọn Có Khe Để Ipad - Đen,OEM,56000,,"Nội thất phòng học, làm việc",96000,40000,42
205757123,Bộ bình ly rượu thủy tinh Cassiopea - Bormioli Rocco - Italy - 7 món,Bormioli Rocco,1170000,Ý,"Ly, cốc & phụ kiện ly",1352000,182000,13
181909421,Nồi Thấp Suit LocknLock CSU1242PIK – 24cm - Màu Pink,LocknLock,597000,Trung Quốc,Nồi và chảo,1184000,587000,50
273203465,"Ruột gối thư giãn K-Bedding by Everon, thư giãn cổ, massage cổ, chống ngáy 45x65cm",K-Bedding,150300,Việt Nam,"Gối, ruột gối, vỏ gối",220000,69700,32
273979627,"Chăn Mỏng Mùa Hè PANICIAN Nhiều Màu Dài 160, Ngang 120 | Index Living Mall | Nội Thất Nhập Khẩu Thái Lan - Phân Phối Độc Quyền Tại Việt Nam",Index Living Mall,149150,Thái Lan,"Chăn, mền và phụ kiện",199000,49850,25
10121655,"Bộ 3 Mũi Khoan Tháp Tầng Bước Titanium 4-32mm Khoan Sắt, Tôn Milliken Tampe NL-3033 (Chuôi tròn)",Milliken Tampe,150000,,Các loại máy và phụ kiện,150000,0,0
203185106,"Nồi Áp Suất Bí Ngô Thông Minh Nồi Hầm 4in1 Đa Năng 8L , Hầm Gà, Cháo - Nồi Chiên, Xào, Nấu Lẩu, Nấu Cơm - Tặng Kèm Xửng Hấp - Chính Hãng MINIIN",MINIIN,116850,Trung Quốc,Nồi và chảo,125000,8150,7
177998723,SÉT 5 THÌA INOX 304 CỰC KỲ CAO CẤP HBH,HBH,69000,Đức,"Đũa, muỗng, nĩa",69000,0,0
137672365,"Cây lau nhà siêu tốc dùng khăn giấy thay thế Scotch-Brite 3M đa năng, xoay 360 độ, lấy sạch bụi và tóc mọi ngóc ngách",Scotch-Brite,303000,Việt Nam,Dụng cụ lau nhà,457000,154000,34
75727537,"Bình lọc trà, pha trà 2 tầng, Bình thủy tinh 2 lớp có lọc trà inox 304 dung tích 500ml - Hàng chính hãng",MO hi,99000,Việt Nam / Trung Quốc,"Bình, ly uống trà và phụ kiện",110000,11000,10
273593965,"Ga chần bông K-Bedding by Everon chất vải Cool Flex (thun lạnh) mềm mát bộ 4 món, không bao gồm chăn KCSP (401&402)",K-Bedding,630800,Việt Nam,,850000,219200,26
162407831,Kệ Để Máy Tính Kết Hợp Kệ Sách Đa Năng Hiện Đại Thương Hiệu IGA - GP184,IGA,186000,Việt Nam,"Nội thất phòng học, làm việc",186000,0,0
200032561,"Đèn Led Dây Leo Năng Lượng Mặt Trời Trang Trí Sân Vườn, Ban Công, 8 Chế Độ Chớp - Chính Hãng NAVIVU",NAVIVU,299000,Trung Quốc,Đèn ngoài trời,299000,0,0
2153235,Bình Giữ Nhiệt Feather Light Lock&Lock LHC4131WR (450ml),LocknLock,299700,Trung Quốc,Bình/ Ly giữ nhiệt,545000,245300,45
274580036,"Hộp Đựng Đũa Thìa Dán Tường HOKORI, Bốn Ngăn Tiện Dụng Có Nắp Đậy, Dán Tường Siêu Chắc Chắn - Hàng Việt Nam",Hokori,189000,Trung Quốc/ Hàn Quốc/ Việt Nam/ Philipin,Phụ kiện nhà bếp,378000,189000,50
273022554,"Móc gỗ KGMT08 treo cà vạt thắt lưng cán gỗ 8 nhánh treo đồ đa năng, móc treo áo lót, túi dễ tiện dụng- Hàng chính hãng",KINGO,39000,Việt Nam,Phụ kiện giặt ủi,69000,30000,43
72660053,Miếng Dán Tường Dự Phòng Cho Kệ Nhà Tắm OENON,OENON,29000,Trung Quốc,,50000,21000,42
273122997,"Kệ gỗ gắn tường bằng vít âm đẹp, kệ gỗ thông nguyên khối trang trí Anzzar-KG01",anzzar,235000,Việt Nam,Nội thất phòng khách,240000,5000,2
202258958,Đệm ngồi | JYSK Lomme | polyester | nhiều màu | nhiều kích thước,JYSK,149000,Trung Quốc,Nội thất phòng khách,149000,0,0
99324909,Vòi xả hồ cấp nước máy giặt xả rửa sàn inox 304 Hobby home decor VIN2,Hobby Home Decor,81000,Trung Quốc,Thiết bị phòng tắm,119000,38000,32
275381276,"Bộ Ấm Chén Pha Trà Cối Xay 8 chi tiết Gốm Sứ Cao Cấp, Kèm Hộp túi cực đẹp làm Quà tặng",XM,283220,Trung Quốc,"Bình, ly uống trà và phụ kiện",289000,5780,2
275016931,"Máy Rửa Xe Cầm Tay Mini 48V, Máy Xịt Rửa Tăng Áp, Công Suất 400W, 2 Pin Dùng Tại Nhà Tiện Lợi",Nhà của Mẹ,437000,China / Vietnam,Máy xịt rửa và phụ kiện,460000,23000,5
185922606,Cốc Thủy Tinh Hai Lớp Cách Nhiệt Ly Đựng Cà Phê Trà Trang Nhã,NAVIVU,86110,Việt Nam,"Ly, cốc & phụ kiện ly",86110,0,0
14462132,Chảo Chống Dính Bếp Từ Fivestar Tặng 5 Muỗng Inox Cao Cấp - Đen,Fivestar,169000,Việt Nam,Nồi và chảo,310000,141000,45
214151723,[HCM]Gối Nằm Gòn TATANA Cao Cấp size 50x70,Tatana,165000,Việt Nam,"Gối, ruột gối, vỏ gối",165000,0,0
274289816,"Bộ cây lau nhà cỡ lớn Kitimop-ProMax có thùng lau nhà tự vắt thông minh kèm bánh xe, chổi lau nhà 360 độ lau sàn làm sạch, 3 bông lau",Kitimop,379000,Việt Nam,Dụng cụ lau nhà,700000,321000,46
273244611,Chảo chống dính siêu bền Elmich Hera II EL-5941GY - Hàng Chính Hãng,Elmich,334400,Việt Nam,Nồi và chảo,479000,144600,30
104680895,Cây Lau Nhà Đơn MyJae Sợi Microfiber Xoay 360 Độ Phù Hợp Cho Nhiều Loại Thùng Lau 134cm,MyJae,199000,China,Dụng cụ lau nhà,330000,131000,40
275407538,Đèn Bàn LED Kẹp Đầu Giường Đọc Sách Chống Cận Pin Sạc,NAVIVU,165000,Trung Quốc,Đèn học và đọc sách,165000,0,0
87651877,ÁO MƯA CỔ RÙA 2 NÓN CAO CẤP KIẾNG - RANDO,Rando,219000,Việt Nam,"Áo mưa, ô dù và phụ kiện đi mưa",219000,0,0
275205913,"CB,Aptomat chống rò chống giật,Chống quá tải 2 pha 20A,32A và 63A RCBO Delixi",HUNONIC,110000,China / Vietnam,"Ổ cắm, ổn áp, biến áp",110000,0,0
273169924,Bộ đũa inox 316 quà tặng DandiHome cao cấp mạ Titanium Plated,DandiHome,223250,Việt Nam,,265000,41750,16
172277879,Đèn Học Kẹp Bàn Chống Cận Cho Học Sinh PaKaSa,PaKaSa,104720,Trung Quốc,Đèn học và đọc sách,164000,59280,36
274755836,"Bộ Ga 4 món Cotton Đũi Tatana mền mịn, thoáng mát",Tatana,52500,Việt Nam,,70000,17500,25
205695928,"Dép đi trong nhà, dép nhà tắm hình sọc lưới - Hàng chính hãng",FuNu,51000,Trung Quốc,Phụ kiện nhà tắm,55000,4000,7
271079108,Bình Giữ Nhiệt La Fonte 380ml - 003520,La Fonte,124000,Trung Quốc,Bình/ Ly giữ nhiệt,240000,116000,48
101858930,"Áo Mưa Khoá Kéo, Áo Mưa Măng Tô Vải Dù Cao Cấp, Hàng Việt Nam, Khổ To Rộng, Chống Thấm Hiệu Quả, Phù Hợp Nam Và Nữ, Có Túi Đựng, Có Lựa Chọn Màu Sắc",XUDI,140000,Việt Nam,"Áo mưa, ô dù và phụ kiện đi mưa",140000,0,0
275407284,"Hộp làm kem 4 ngăn chất liệu nhựa PP nguyên sinh an toàn cho sức khỏe , Khuôn làm kem 4 ngăn dễ sử dụng - Hàng chính hãng (giao màu ngẫu nhiên)",PaKaSa,49000,Trung Quốc,Phụ kiện nhà bếp,98000,49000,50
13877177,Đèn Sạc Khẩn Cấp Kentom KT301,Kentom,302000,Việt Nam,,302000,0,0
275379091,"Dụng cụ làm cơm cuộn , cơm rong biển cuộn sushi tiện lợi - Hàng chính hãng",PaKaSa,69000,Trung Quốc,Dụng cụ làm bánh,138000,69000,50
14935044,Vợt Muỗi Sunhouse SHE-E350 - Màu Xanh *50,Sunhouse,81000,Trung Quốc,"Dụng cụ diệt chuột, côn trùng",98000,17000,17
159012113,Đũa Inox 304 Kháng Khuẩn Không Trơn Trượt Hoa Văn Tinh Tế  BUGU SK-P02 - Hàng Chính Hãng,Bugu,157000,Việt Nam,"Đũa, muỗng, nĩa",159000,2000,1
67932480,Topper Everon White,Everon,764150,Hàn Quốc / Indonesia / Việt Nam,Nệm và phụ kiện,899000,134850,15
182729311,VÕNG XẾP DUY LỢI INOX - CỠ LỚN (QUÀ TẶNG 10 MÓC ÁO KÉP NHỰA CAO CẤP DUY LỢI),Duy Lợi,1618000,Việt Nam,Phụ kiện phòng ngủ,1618000,0,0
193002479,"Sạc Pin Đa Năng BESTON C906W dùng cho pin AA/AAA/9V/C/D Sạc nhanh, tự ngắt, có màn hình LCD báo phần trăm",BESTON,270000,Trung Quốc,Pin và dụng cụ sạc pin,270000,0,0
253426939,Bình Giữ Nhiệt Lock&Lock 450ml siêu nhẹ Feather Light Ring Tumbler LHC4131,LocknLock,289000,Trung Quốc,Bình/ Ly giữ nhiệt,510000,221000,43
149940546,"Mỏ hàn chì - Mỏ hàn thiếc 60W Wynn’s, sử dụng lõi gia nhiệt tăng cường, lên nhiệt nóng nhanh, mối hàn đẹp, bóng, an toàn",Wynn's,82000,Việt Nam,Các loại máy và phụ kiện,82000,0,0
130354999,"Dụng Cụ Xay Tỏi, Ớt ,Gia vị, Thực Phẩm Đa Năng Cầm Tay - Nhanh Chóng Tiện Lợi - Hàng Chính Hãng MINIIN",MINIIN,45000,China / Vietnam,Phụ kiện nhà bếp,65000,20000,31
274580113,Hộp đựng gạo - Thùng đựng gạo tiện ích 10kg Hokori Việt Nhật Có Nút bấm lấy gạo tự động Tặng Kèm Ca Đong Gạo - Hàng Việt Nam,Hokori,249000,Việt Nam,Dụng cụ chứa đựng thực phẩm,498000,249000,50
158804921,"Gối ngủ cao su non vỏ sợi tre kháng khuẩn cao cấp cho người lớn EMA - Phong cách Nhật Bản - Chống đau mỏi cổ vai gáy, ngủ ngáy - KT 50x30x10cm",Ema,129000,Trung Quốc,"Gối, ruột gối, vỏ gối",258000,129000,50
275226851,"Ngăn Kéo Nhựa Nhỏ Mini, Khay Đựng Bút Gắn, Hộp ngăn kéo Treo Dưới Bàn Làm Việc Giúp Cất Giữ Gọn Gàng Bàn Làm Việc (Giao Màu Ngẫu Nhiên)",OEM,149000,Trung Quốc,"Nội thất phòng học, làm việc",155000,6000,4
205879338,"Bàn làm việc chân gấp gọn,chân sắt mặt gỗ công nghiệp nhiều màu,nhiều kích thước",HG FURNITURE,400000,Việt Nam,"Nội thất phòng học, làm việc",400000,0,0
207007515,"Kệ Nhựa Đựng Vật Dụng 2 Tầng GROFA - Hàng Chính Hãng , Giao màu ngẫu nhiên",Gro-Fa,59000,Trung Quốc,,59000,0,0
273983103,"Bàn làm việc màu gỗ sáng kích thước lớn kèm giá sách, bàn học để máy tính khung chân sắt sơn tĩnh điện trẻ trung hiện đại thiết kế phong cách Bắc Âu",Nội Thất 5C,835000,Trung Quốc,"Nội thất phòng học, làm việc",850000,15000,2
42491736,"Bút thử nước TDS, dụng cụ đo TDS, máy đo độ cứng của nước - Hàng chính hãng",SMY,122000,,Thiết bị đo lường,135000,13000,10
275012243,Đồng Hồ Treo Tường Cao Cấp DẠ QUANG EASTAR Mặt Tròn Lớn Viền Mỏng 38cm – Số nổi 3D – Máy NHẬT KIM TRÔI - Tặng Pin Maxell - BH 1 Năm - Treo Tường Decor Trang Trí Nhà Cửa,Eastar,449000,China,Đồng hồ,449000,0,0
59273521,"Combo 02 Khăn tắm, khăn mặt FUNU, mềm mịn, siêu thấm, kháng khuẩn - Hàng chính hãng, hàng nhiều mẫu design, giao mẫu ngẫu nhiên",FuNu,92000,Việt Nam / Trung Quốc,Khăn,100000,8000,8
274418301,Móc Dán Inox Treo Đồ Nhà Tắm Tiện Lợi,NAVIVU,14200,Trung Quốc,Phụ kiện giặt ủi,14200,0,0
225194894,Van chia KG55 có khóa 2 đường nước dễ tiện lợi cao cấp inox sus304 - Hàng chính hãng,KINGO,50000,Việt Nam,Thiết bị phòng tắm,95000,45000,47
272443755,Bộ 2 cốc silicone Little Luv LocknLock LBB015S7 - kèm nắp đậy và ống hút - Dung tích 200ml,LocknLock,431000,Hàn Quốc,"Ly, cốc & phụ kiện ly",820000,389000,47
275354902,SALE SỐC NỆM VĂN PHÒNG- ĐỆM NGỦ VĂN PHÒNG CHỐNG THẮM NƯỚC 75 X 180 X 3CM ( GIAO MÀU NGẪU NHIÊN ),KINGROLL MATTRESS R,259000,Việt Nam,Nệm và phụ kiện,350000,91000,26
72904497,Kệ Nhà Tắm Kèm Nhả Kem Đánh Răng Tự Động 2 Cốc OENON Lắp Đặt Dán Tường - OEKEM,OENON,159000,Trung Quốc,,300000,141000,47
77118111,"Giàn phơi, kệ phơi đồ Inox xếp gọn có bánh xe - Chính hãng NIKITA 818ABX",Nikita,979000,Trung Quốc,Phụ kiện giặt ủi,1189000,210000,18
58051231,Khuôn làm bánh pizza hình tròn bằng thép carbon chống dính-R009,Romisa,40000,Trung Quốc,Dụng cụ làm bánh,40000,0,0
122229409,Vòi rửa bát nóng lạnh dây rút inox 304 Pimisi dùng cho chậu rửa chén bát trong nhà bếp gắn chậu với đầu vòi 2 chế độ nước tăng áp và dây rút mềm tiện lợi đa năng | Hàng chính hãng,Pimisi,627000,Việt Nam,Phụ kiện nhà bếp,1000000,373000,37
213710307,"Lưỡi cưa xích RAKUTEN LOẠI 1 gắn máy mài cầm tay, bộ dụng cụ chuyển đổi máy mài thành máy cưa gỗ mini",rakuten,139000,Trung Quốc,"Đá cắt, que hàn, cưa & lưỡi cưa",139000,0,0
3871795,Tinh dầu thơm phòng Hàn Quốc cao cấp 130ml,Sandokkaebi,148000,Hàn Quốc,"Đèn xông tinh dầu, tinh dầu và phụ kiện",148000,0,0
274887797,Bình Giữ Nhiệt Báo Nhiệt Độ Cảm Ứng Inox Cao Cấp 304 (Màu ngẫu nhiên) - Hàng chính hãng ,Gro-Fa,88000,Trung Quốc,Bình/ Ly giữ nhiệt,88000,0,0
274728985,"Cây Lăn Bụi Quần Áo, Ga Giường, Sofa, Lăn Lông Chó Mèo 16cm Có Lõi Thay Thế Tiện Lợi - PEAFLO",PEAFLO,42000,Hàn Quốc / Trung Quốc,Phụ kiện giặt ủi,42000,0,0
275073778,Đèn pin mini siêu sáng bỏ túi 2in1 có zoom xa gần kèm hộp đựng- Hàng chính hãng ,Gro-Fa,49000,Trung Quốc,,49000,0,0
166429634,"Móc Treo Quần Áo, Móc Treo Đa Năng Hara, Bộ Sưu Tập Móc Quần Áo Người Lớn Nhựa Cao Cấp Inochi",Inochi,29000,Việt Nam,Phụ kiện giặt ủi,29000,0,0
480128,Bình Nước Thể Thao PC Lock&Lock HPP722 - 700Ml,LocknLock,100000,Việt Nam,,168000,68000,40
274791033,Bộ Ấm Chén Pha Trà Cối Xay Gốm Sứ Gosu Chất Liệu Gốm Sứ,GOSU,279000,Trung Quốc,"Bình, ly uống trà và phụ kiện",349000,70000,20
37317513,Keo Bột bả vá tường thông minh siêu tốc tiện lợi tặng kèm bay khi mua 2 sản phẩm trở lên,OEM,51500,Trung Quốc,Dụng cụ sửa chữa nhà cửa,51500,0,0
19749652,Bộ Áo Mưa Vải Dù không thấm nước cao cấp,OEM,179597,,"Áo mưa, ô dù và phụ kiện đi mưa",199000,19403,10
274045494,"Bộ Tua Vít 32 Đầu , Bộ Dụng Cụ Sửa Chữa Đa Năng PaKaSa - Hàng chính hãng ",PaKaSa,144000,Trung Quốc,,144000,0,0
249835417,Giá treo quần áo KG44 kèm 8 móc bên hông khung kim loại chắc chắn tiện lợi đa năng 150x110cm - Hàng chính hãng,KINGO,225000,Việt Nam,Phụ kiện giặt ủi,285000,60000,21
119074088,Kệ đọc kinh giá đỡ sách bằng tre size 29x39cm,Diệu Tâm,230000,Trung Quốc,"Nội thất phòng học, làm việc",230000,0,0
52636102,Đàn Guitar Thùng Woim Dáng D Full Phụ Kiện Tặng Khoá học Miễn Phí,Woim,426550,,"Đàn guitar, ukulele",449000,22450,5
271064558,Bình giữ nhiệt Lafonte 3000761 - BLUE 500ml,La Fonte,143000,Trung Quốc,Bình/ Ly giữ nhiệt,286000,143000,50
3604691,Đèn Bắt Muỗi Điện Quang ĐQ EML02 BL,Điện Quang,205000,Trung Quốc,,205000,0,0
41349312,Đồng hồ gỗ để bàn hình khối chữ nhật mặt số hiển thị LED - Đo nhiệt độ phòng - Cảm biến Âm thanh GB-DHG03,OEM,200000,Hong Kong,Đồng hồ,200000,0,0
13877176,Đèn Sạc Khẩn Cấp Kentom KT2200,Kentom,299000,Việt Nam,,299000,0,0
177679445,"Chuông Cửa Không Dây Thông Minh Besti YBT01 (1 Nút Bấm, 1 Chuông ), Chống Nước, Khoảng Cách Sử Dụng Hiệu Quả 300M, 60 Loại Nhạc Chuông, 4 Mức Điều Chỉnh Âm Lượng - Hàng Chính Hãng",Besti,200000,Trung Quốc,Bảo vệ nhà cửa,200000,0,0
275590893,Găng Tay Y Tế Size L Không Bột Nitrile Màu Đen TTGLOVES (100 chiếc),TTGloves,79000,"Anh, Việt Nam",Dụng cụ vệ sinh,79000,0,0
275255851,"Rèm cửa dán tường DULCETT chống nắng, rèm cửa dán mẫu GẤU HELLO trang trí cửa sổ - phòng khách dễ dàng lắp đặt không khoan đục rèm cửa sổ dán",DULCETT,45000,Trung Quốc,Nội thất phòng khách,50000,5000,10
104269963,"SƠN CHỐNG THẤM, SƠN HỒ CÁ KOI FLINKOTE NO.3 - 3.5L",Flintkote,399000,Thái Lan,"Sơn, dầu mỡ, hóa chất",399000,0,0
273928853,"Võng Mùng Du Lịch 3 Lớp Gubix Chống Muỗi Và Côn Trùng Gấp Gọn, Tiện Dụng",Gubix,258000,Việt Nam,Phụ kiện phòng ngủ,258000,0,0
273400099,Keo Dán Chống Thấm Siêu Dính Nhật Bản Bosui Dài 5m,PEAFLO,37000,HK/TQ,Dụng cụ sửa chữa nhà cửa,45000,8000,18
148631279,Ly thủy tinh tay cầm nắp vặn 450ml Bormioli Rocco- HÀNG CHÍNH HÃNG,Bormioli Rocco,33000,Việt Nam,"Ly, cốc & phụ kiện ly",33000,0,0
274751044,Dao chặt xương thép nguyên khối Sunhouse KS-KN200CS,Sunhouse,184000,Việt Nam,"Dao, kéo và phụ kiện",310000,126000,41
38160183,"Ổ Cắm Công suất lớn Điện Quang ĐQ ESKHP 3RB ( 3 lỗ, Màu Đỏ Đen, Không Dây)",Điện Quang,81900,Việt Nam,"Ổ cắm, ổn áp, biến áp",102293,20393,20
235862463,"Khay Gỗ Ấm Chén Bọc Viền Đồng Nâu, Kích Thước 43x28x5.5cm - Hàng Nhập Khẩu",DORON the best service,275000,Trung Quốc,Phụ kiện phòng ăn,275000,0,0
6077793,Ổ Khoá Việt Tiệp Chống Cắt Loại Lớn 96 x 60 Ống Phi 12mm,Việt Tiệp,171000,Việt Nam,Bảo vệ nhà cửa,171000,0,0
215897010,Móc Treo Đồ Nhà Bếp 6 Móc Dán Tường Xoay 360 Độ,NAVIVU,23700,Trung Quốc,,23700,0,0
980486,Cân Đồng Hồ Lò Xo Nhơn Hòa NHS-30 (30kg) - Hàng Chính Hãng,Nhơn Hòa,710000,Việt Nam,Dụng cụ làm bánh,710000,0,0
271078977,Bình nước thể thao 2 tầng La Fonte 450ml - 004091 - GRE,La Fonte,87600,Trung Quốc,,172000,84400,49
138395631,Đầu vòi rửa chén tiết kiệm nước k9 - Xoay 360 có lọc Shalla DKC51 Tặng bút cảm ứng,Shalla,12978,Đài Loan,Phụ kiện nhà bếp,18099,5121,28
178827552,"(Tiện Dụng) Khay Lọc Rác Mỏ Vịt KHONCC Hàng Chính Hãng - Gắn Vòi Rửa Bát , Bồn Rửa Chén Hình Thiên Nga Đa Năng - NTM-LRHTN (Nhiều Màu)",KHONCC,4900,Việt Nam,Phụ kiện nhà bếp,9800,4900,50
155162910,Bình Pha Cà Phê French Press Timemore U | Pha Cà Phê Kiểu Pháp,Timemore,470000,China,"Bình, ly uống cà phê và phụ kiện",470000,0,0
14655604,Nồi Tráng Men Nhật Bản Cao Cấp Fujihoro - Sử Dụng Bếp Từ - Trắng,Fujihoro,608000,Thái Lan,Nồi và chảo,1050000,442000,42
146845870,"Đèn Bàn Học Chống Cận Thị, Đèn Đọc Sách, Đèn Làm Việc Bảo Vệ Mắt - Đèn Bàn Học LED USB Di Động Cao Cấp Có Thể Gập Hai Chỗ – 03 Chế Độ Ánh Sáng Vàng Bảo Vệ Mắt Chống Cận, đèn học để bàn, đèn học cho học sinh sinh viên, trang trí - Hàng Chính Hãng dododios",dododios,228000,China,Đèn học và đọc sách,228000,0,0
130812731,"Bộ 4 Miếng dán thay thế treo kệ INOX, Miếng dán pvc dán tường gạch men siêu chắc - PVC04",OENON,25000,Trung Quốc,,50000,25000,50
273407270,Máy bắn đinh súng bắn đinh betong bắn đa vật liệu thế hệ mới mẫu có 50 đinh và mẫu không có đinh tặng kèm bao tay và măt kính,247 RACING,115000,Trung Quốc,Các loại máy và phụ kiện,115000,0,0
275791645,"Bàn Chải Đánh Răng 3 Mặt, Bàn Chải Đánh Răng Thế Hệ Mới Giúp Làm Sạch cả 3 Mặt Răng, COMBO 4 CHIẾC, Lông Mềm Mại Đánh Bay Mọi Mảng Bám",HT SYS,99000,Trung Quốc,Phụ kiện nhà tắm,99000,0,0
225207236,"Keo chống thấm Epoxy 2 thành phần A - B trong suốt, sử lý chống thấm mặt sàn nhà vệ sinh, quét bảo vệ gạch men",TAIKOMI,303280,Việt Nam,Dụng cụ sửa chữa nhà cửa,303280,0,0
116244976,"Túi Đựng Hộp Cơm Grepaco Giữ Nhiệt Nóng Lạnh Đựng Đồ Thức Ăn Văn Phòng, Du Lịch – Vải Bố Canvas, Kích Thước To (Cỡ Lớn), Kiểu Dáng Giỏ Xách Thời Trang Nam Nữ - Tặng Túi Đựng Muỗng Nĩa",GREPACO,149000,Việt Nam,Phụ kiện nhà bếp,149000,0,0
249578170,Nồi sứ đáy từ 2 Lít NodaCook (Nâu) - Chuyên dụng nấu trên Bếp từ,NodaCook,825000,Việt Nam,Nồi và chảo,830000,5000,1
97547725,"Hộp Đựng Trang Sức , Dấu Giám Đốc Gỗ Tự Nhiên Lót Nhung Đỏ Chính Hãng TOKDODO",TOK DO DO TOKDODO TOK DO DO,142500,Việt Nam,Phụ kiện phòng ngủ,150000,7500,5
274735685,Kính Bảo Hộ Chống Hóa Chất 3M 334 ,3M,115000,Mỹ,,120000,5000,4
124891708,"Kệ inox treo miếng rửa chén đựng đồ xà bông không gỉ, có chốt gắn được vào tất cả vòi nước , chất liệu inox 304 không gỉ",KINGO,43000,Việt Nam,,75000,32000,43
272035598,HỘP 10 ĐÔI ĐŨA INOX 304 - CAO CẤP - SANG TRỌNG - NGUYÊN KHỐI INOX 304,Jodily StarHome,175000,Việt Nam,"Đũa, muỗng, nĩa",175000,0,0
40699059,Ổ cắm Điện Quang ĐQ 002A-02-2M (3 lỗ dây 2m),Điện Quang,99000,Việt Nam,"Ổ cắm, ổn áp, biến áp",123164,24164,20
208193723,"Nhang nụ trầm hương 45 viên, tẩy uế khí, thanh lọc không khí, thư giãn tinh thần",FuNu,47500,Trung Quốc,,50000,2500,5
95278564,Bộ quần áo mưa GIVI RRS06,GIVI,760000,Việt Nam,"Áo mưa, ô dù và phụ kiện đi mưa",760000,0,0
2879911,Khuôn bánh khọt chống dính 12 lỗ Vạn Lợi,Dragon,185000,Việt Nam,Dụng cụ làm bánh,185000,0,0
275194952,CÂY LAU NHÀ HƠI NƯỚC LEIFHEIT CLEAN TENSO Hàng chính hãng,Leifheit,2310000,Đức,Dụng cụ lau nhà,2340000,30000,1
144492733,"Nệm cói/đệm ngồi bệt cói ONGTRE cao cấp dành cho nhà hàng, quán cafe, phòng khách, đệm yoga",ongtre,115000,Việt Nam,Nội thất phòng khách,115000,0,0
149366628,Ghế xoay văn phòng Xuân Hòa GNV-01-00,Xuân Hòa,700000,Việt Nam,"Nội thất phòng học, làm việc",700000,0,0
274661946,"Bộ 3 Túi Đựng Rác Màu Grofa , Túi Đựng Rác Gia Đình , Văn Phòng ..vv - Hàng chính hãng",Gro-Fa,59000,Việt Nam,Dụng cụ vệ sinh,59000,0,0
275128816,"Ổ cắm điện chuyển đổi đa chức năng dùng khi xuất ngoại, đi du lịch,... ",ratoff-ars,90000,China,"Ổ cắm, ổn áp, biến áp",90000,0,0
432975,Bộ Vặn Vít Đa Năng 38 Món Bosch – 2607019506 (Hộp Đen),Bosch,389000,Trung Quốc,Các loại máy và phụ kiện,475000,86000,18
196563202,Bát Ăn Amori Sản Xuất Theo Tiêu Chuẩn Xuất Nhật Chất Liệu Nhựa Nguyên Sinh Đảm Bảo An Toàn Tuyệt Đối Cho Người Sử Dụng- Chính Hãng inochi ( Tặng kèm khăn lau pakasa),Inochi,25000,Việt Nam,"Tô, chén, dĩa",38800,13800,36
196552387,Muỗng Xới Cơm Chống Dính Sendai Sản Xuất Theo Tiêu Chuẩn Nhật Bản An Toàn Tuyệt Đối Cho Người Dùng - Chính Hãng Inochi ( Tặng kèm khăn lau chén pakasa ),Inochi,29000,Việt Nam,Phụ kiện nhà bếp,39800,10800,27
71003207,Hạt giống Hoa Đồng Tiền F1 Mix - giống nẩy mầm khỏe hoa to VTS115,Sen Vàng Seeds,14040,Hà Lan,"Hoa tươi, Cây cảnh & Hạt giống",14040,0,0
56958189,Đầu phun tạo bọt Karcher FJ 10,Karcher,550309,Đức,Máy xịt rửa và phụ kiện,579273,28964,5
80857108,Bộ Sake gốm sứ men hỏa biến Bát Tràng cao cấp-300ml- Đĩa quạt,Bát Tràng,380000,Việt Nam,"Ly, cốc & phụ kiện ly",380000,0,0
122908951,Ghế Học Sinh Chống Gù Thông Minh Điều Chỉnh Độ Cao BHS288 Mẫu Mới - Hàng Chính Hãng,pehouse,999000,Việt Nam / Trung Quốc,"Nội thất phòng học, làm việc",1449000,450000,31
191378480,"[HỘP 500cây] Nhang Quế Thiên Nhiên MỘC LÂM 29cm, Nhang Sạch, Ít Khói, Hương Thơm Thanh Dịu Tự Nhiên",mộc lâm,91771,Việt Nam,,97629,5858,6
172904887,NỆM CAO SU NON MASSAGE THẮNG LỢI- HÀNG CHÍNH HÃNG- BẢO HÀNH 15 NĂM VỀ SỤT LÚN- ĐỦ SIZE TỪ 1m-2.2m,Nệm Thắng Lợi,1100000,Việt Nam,Nệm và phụ kiện,1100000,0,0
273746766,"Ly nhựa 2 lớp LocknLock Bubble Tea Cold Cup HAP529 720ml, Hàng chính hãng, kèm ống hút trân châu - JoyMall",Lock&Lock,119300,Hàn Quốc / Trung Quốc,"Bình, ly uống trà và phụ kiện",217000,97700,45
166716604,"Kệ úp chén bồn rửa 85cm cao cấp VANDO thép carbon không gỉ, chống xước, sơn tĩnh điện, giá kệ để bát tiện lợi",VANDO,499000,Việt Nam,,499000,0,0
4298679,Combo 10 miếng dán treo móc đồ chắc khỏe,OEM,35000,Việt Nam,Phụ kiện giặt ủi,35000,0,0
179562614,"NỒI INOX 5 ĐÁY SUNHOUSE SHG788-16,20,24 -size 16,20,24cm",Sunhouse,159500,Việt Nam,Nồi và chảo,159500,0,0
31513982,Cân Điện Tử Kỹ Thuật Số Màn Hình Led 50kg Cho Khách Du Lịch,OEM,95000,Trung Quốc,Dụng cụ làm bánh,95000,0,0
183057936,Set 50 khuôn giấy nến vàng thấm dầu lót nồi chiên không dính,OEM,39000,Hàn Quốc / Trung Quốc,Phụ kiện nhà bếp,39000,0,0
275016415,"Đèn Led Xoay Trang Trí 7 Màu, Đèn Led Xoay Vũ Trường, Bar, Sân Khấu - Hàng chính hãng ",Gro-Fa,92000,Trung Quốc,,92000,0,0
139973216,"Thau, Chậu Nhựa Gấp Gọn Đa Năng Dùng Trong Bệnh Viện , Trường Học , Công Sở Tặng Kèm Móc Treo Dán Tường - PaKaSa ( Màu ngẫu nhiên )",PaKaSa,96390,Trung Quốc,Phụ kiện giặt ủi,156000,59610,38
556663,Giàn Phơi Inox Đơn Lắp Ráp CB - 1.55x1.4m,Prota,315000,Việt Nam,Phụ kiện giặt ủi,350000,35000,10
99516576,"BÌNH THỦY TINH CAO CẤP ĐẾ GỖ ĐỰNG NƯỚC HOA QUẢ, NƯỚC ÉP TRÁI CÂY CÓ VÒI VẶN TIỆN LỢI - VD705",CRYSTAN,799900,Trung Quốc,,799900,0,0
45210345,Kệ Đựng Mỹ Phẩm Đồ Trang Điểm Trang Sức 4 Tầng Ngăn Kéo Tiện Dụng,OEM,135000,Việt Nam,Phụ kiện phòng ngủ,145000,10000,7
795037,Gối Cao Su Vạn Thành Dợn VTGCSD4563 (45 x 63 cm) - Trắng,Vạn Thành,403000,Việt Nam,"Gối, ruột gối, vỏ gối",660000,257000,39
83344208,"Ghế xếp thư giãn SUMIKA 639 - Dòng cao cấp, bề rộng 73cm, vải lưới Textilene thoáng khí, tải trọng 300kg",Sumika,860000,Trung Quốc,Nội thất phòng khách,1580000,720000,46
19449329,Dây Đàn Guitar Classic Alice 139,Alice,99000,,Phụ kiện đàn,99000,0,0
982478,Combo 2 Ruột Gối Gòn Bi Cao Cấp Drap24 (40 x 60 cm),Drap24,96000,Việt Nam,"Gối, ruột gối, vỏ gối",96000,0,0
106056414,Vỉ 5 Viên Pin CR2450 3V Panasonic - Hàng Chính Hãng,Panasonic,120000,Malaysia,Pin và dụng cụ sạc pin,120000,0,0
274184723,Khăn Lau Mặt Khô Jomi 80 Miếng,Jomi,57000,Việt Nam,,57000,0,0
275227949,Xịt Đuổi Muỗi Nanoz Dùng Trên Da An Toàn Với Trẻ Nhỏ,fofaHome,16000,Việt Nam,"Dụng cụ diệt chuột, côn trùng",43000,27000,63
275059651,"Chổi quét nhà Scotch-Brite 3M đa năng, cao cấp với sợi nylon siêu bền, không cong vênh",3M,88000,Mỹ,Dụng cụ lau nhà,113000,25000,22
195874537,Bộ chày cối inox SUS 304 cao cấp - HENRYSA,HENRYSA Bạn của mọi nhà,169000,Trung Quốc,Phụ kiện nhà bếp,240000,71000,30
69927147,Túi Đựng Hộp Cơm Giữ Nhiệt Đa Lớp Nhiều Hoa Văn - Xanh Denim,OEM,30000,Trung Quốc,Phụ kiện nhà bếp,30000,0,0
275200559,"Bật rác vuông Hokori 10L, 15L, 20L thiết kế hiện đại, sang trọng nhựa tự nhiên đúc nguyên khối - Hàng Việt Nam",Hokori,259000,Việt Nam,Dụng cụ vệ sinh,508000,249000,49
174184368,Topper làm mềm nệm LIDACO chuyên dùng khách sạn vải cotton chuẩn dày 7cm,LIDACO,379000,Việt Nam / Trung Quốc,Nệm và phụ kiện,379000,0,0
72751318,"Báo Động Chống Trộm, Chuông Báo Khách Mở Cửa Đa Chức Năng Có Điều Khiển Từ Xa MC - 02, Báo Động Nhiều Chế Độ : Chống Trộm Xâm Nhập , Báo Chuông Cửa..",CTFAST,199000,Trung Quốc,Bảo vệ nhà cửa,199000,0,0
10647257,Ổ cắm Điện Quang ĐQ ESK 2B.SM750SL (5 lỗ 3 chấu dây 2 mét màu Đen Trắng Đỏ),Điện Quang,190947,Việt Nam,"Ổ cắm, ổn áp, biến áp",238700,47753,20
197656119,Nồi Sứ Dưỡng Sinh Minh Long Healthy Cook Vesta 3.0L - Dùng Cho Bếp Từ,Minh Long,1485000,Việt Nam,Nồi và chảo,1485000,0,0
275572473,Bộ Dụng Cụ Làm Sushi 10 Món Khuôn Làm Cơm Cuộn,PEAFLO,115000,Thái Lan / Trung Quốc / Malaysia (Tùy từng đợt nhập hàng),Dụng cụ làm bánh,149000,34000,23
275006108,"Phân bón NPK 16-12-8-11S+TE Greenhome, Better, Bao 1kg, Phát Triển Nhanh Thân, Cành, Lá, Bộ Rễ",Better,13900,Việt Nam,"Hoa tươi, Cây cảnh & Hạt giống",27000,13100,49
133245917,Hộp Đựng Bàn Chải Và Nhả Kem Đánh Răng Tự Động Tặng Kèm  Cốc Hút Từ -Kệ Để Đồ Nhà Tắm Dán Tường Tiện Lợi- Hàng Chính Hãng MINIIN,MINIIN,126350,China / Vietnam,,199000,72650,37
164925241,Lô Túi Rác Soji 4 Inochi tiện dụng,Inochi,75000,Việt Nam,Dụng cụ vệ sinh,75000,0,0
272304434,"Đèn Led Đom Đóm Dây Đồng Uốn Dẻo Trang Trí Noel, Giáng Sinh, Năm Mới",NAVIVU,15000,Trung Quốc,,15000,0,0
190510330,"Dây Buộc Cành Greenhome, Dài 50m, Kẽm Bọc Nhựa, Tích Hợp Đầu Cắt Tiện Lợi, Cố Định Thân Cây, Làm Giàn Leo",Greenhome,35900,Việt Nam,,60000,24100,40
73553244,Hộp Đựng Trang Sức MOHI MH10 Kích Thước 10x10x5.5cm - Hàng Chính Hãng,MO hi,66500,Trung Quốc,Phụ kiện phòng ngủ,70000,3500,5
179981670,Hũ thủy tinh nắp cài kín hơi Fido - Bormioli Rocco 149270M02321991 (5000ml),Bormioli Rocco,397000,Ý,Dụng cụ chứa đựng thực phẩm,460000,63000,14
190726146,GHẾ - GIƯỜNG XẾP DUY LỢI INOX - CỠ LỚN ( QUÀ TẶNG 10 MÓC ÁO),Duy Lợi,1179000,Việt Nam,Nội thất phòng ngủ,1179000,0,0
93140551,"Dụng cụ mở nắp chai, mở lon, khui bia, mở đồ đóng hộp đa năng 20x4.5 cm",SOHOGO,59000,Trung Quốc,Phụ kiện nhà bếp,59000,0,0
84776281,"Ống nối vòi nước,dây bơm nước cho máy bơm,vòi xịt phun nước rửa xe,tưới cây 206576-1 (xám)",OEM,98899,Việt Nam,Dụng cụ làm vườn,98899,0,0
7202317,Bộ 3 Hộp KOVA KLOCK400 (400ml/Hộp),KOVA,138000,Trung Quốc,Dụng cụ chứa đựng thực phẩm,200000,62000,31
167610171,"Đệm Gấp Văn Phòng - Tặng Kèm Gối Hơi - Chất Liệu Bông Ngọc Trai Dài 190x70 Cm, Dày 1 Cm - Đệmệm Gấp Ngủ Trưa Văn Phòng Siêu Nhỏ Gọn - Foldable Sleeping Office Mattress",SKYPIEA,350000,Việt Nam / Đài Loan,Phụ kiện phòng ngủ,350000,0,0
272256501,Ca Đánh Sữa Mạ Màu,NOX COFFEE TAKE AWAY,120000,Việt Nam,,120000,0,0
7349421,Khăn Trải Bàn PAULEE - FY 116L,PAULEE,171000,Đài Loan,Phụ kiện phòng ăn,190000,19000,10
275426305,Túi Treo Quần Áo Chống Bám Bụi Bẩn PaKaSa ( Giao màu ngẫu nhiên),PaKaSa,39000,Trung Quốc,Phụ kiện giặt ủi,78000,39000,50
206473614,"Túi Vải Đựng Quần Áo, Chăn Ga Gối Màn Gấu Bông, Sách Vở Khéo Khoá Deli - Hộp Vải Đựng Đồ Đa Năng Khung Thép Chịu Lực Cao Cấp - Nhiều Size Kích Cỡ Lớn Nhỏ",Deli,75000,Trung Quốc,Phụ kiện phòng ngủ,135000,60000,44
59598451,"Miếng xốp bọc chân cửa chắn gió chống bụi, ngăn tiếng ồn, ngăn côn trùng 93 x 9.6cm",OEM,9000,Trung Quốc,Bảo vệ nhà cửa,15879,6879,43
88792564,"Dây Đèn LED Trí Gương Bàn Trang Điểm 15 Bóng Dài 5 Chế Độ Sáng, Chống Nước",OEM,242100,Trung Quốc,,242100,0,0
46635014,1 GIỎ SẮT Treo Chậu Hoa Ban Công Hình Tròn - Màu Đen,OEM,20000,Việt Nam,"Hoa tươi, Cây cảnh & Hạt giống",23000,3000,13
275244851,"Ampe kềm đo điện AC kỹ thuật số TOTAL TMT46003 - Kèm túi dựng, Ampe kìm, độ chính xác cao, màn hình LCD 6000 số đếm, có đèn nền ban đêm, có kèm pin",Total,425000,Trung Quốc,Thiết bị đo lường,439000,14000,3
204046661,Ghế xoay văn phòng lưng quạt -AD010,Ánh Dương,429000,Trung Quốc,"Nội thất phòng học, làm việc",429000,0,0
260669109,Bông tắm Bao tay tắm Cao cấp Sợi vải lưới mềm mại Tạo bọt Rất bền,CHIKIGON,27000,Trung Quốc,Phụ kiện nhà tắm,27000,0,0
194326113,"Xe đẩy hàng gấp gọn đi chợ (đi kèm dây buộc) FUJIHOME HT-245, xe kéo hàng đi chợ gấp gọn mini siêu thị đa năng - Hàng Nhập Khẩu",Fujihome,231830,Trung Quốc,Xe đẩy hàng,239000,7170,3
140565222,Thảm trải sàn hình sao ONGTRE bằng Cói trang trí nhà cửa chụp ảnh nhiều kích thước 60/80/100/120/150/180cm,ongtre,330000,Việt Nam,Trang trí nhà cửa khác,330000,0,0
54658075,"Bộ drap giường cotton trắng A cao cấp (1 ga, 2 vỏ gối, 1 vỏ gối ôm)",A,305000,Việt Nam,,361000,56000,16
274890225,"Hộp Cơm Lúa Mạch 2 Tầng 3 Ngăn Có Tay Cầm Kèm Muỗng, Chất Liệu Nhưa Lúa Mạch An Toàn Cho Sức Khỏe Người Dùng - Chính Hãng",PaKaSa,89250,Trung Quốc,Dụng cụ chứa đựng thực phẩm,144000,54750,38
165652318,Bàn Chải Chà Lưng Kèm Bông Tắm 2in1- Cọ Chà Lưng Masage Tẩy Tế Bào Chết Cao Cấp - Hàng Chính Hãng (Giao Màu Ngẫu Nhiên),lilahome,28000,Việt Nam / Trung Quốc,Phụ kiện nhà tắm,29000,1000,3
143006397,"Vỉ 20 Nẹp Dán Tường Giữ Cố Định Dây Điện, Nhiều Màu Lựa Chọn, Dây Mạng, Dây Máy Tính - Tiện Dụng Gia Đình - Văn Phòng. TakyHome 5733",taky home,24500,Malaysia,,24500,0,0
273378437,"Keo dán siêu dính - Keo siêu dính nhật bản ,dính mọi đồ vật và mọi bề mặt chắc như bê tông",247 RACING,17000,Trung Quốc,Dụng cụ sửa chữa nhà cửa,17000,0,0
2075139,"Trầm nụ tháp nhỏ - 40g - 60 viên - Xông nhà , xông phòng , thanh lọc không khí - Chuyên dùng cho các lò xông , lư xông - Nhang Thiền",Nhang Thiền,165000,Việt Nam,,165000,0,0
93404378,Sào Phơi Đồ Chát Liệu Inox Qui Phúc Cao Cấp.,Qui Phúc,639900,Việt Nam,Phụ kiện giặt ủi,639900,0,0
196051243,"Búa Lùn Nguyên Khối Deli Chính Hãng - Đóng Đinh, Nhổ Đinh Dễ Dàng, Tiện Dụng - Nhỏ Gọn, Tay Cầm Bọc Cao Su - DL441008",Deli,66000,Trung Quốc,Dụng cụ sửa chữa nhà cửa,118800,52800,44
174609283,Kệ Màn Hình Để Bàn Làm Việc Đơn Giản SIB Decor KDB23,SIB DECOR,173000,Việt Nam,"Nội thất phòng học, làm việc",250000,77000,31
68237257,Hạt giống hoa Hướng Dương Tháp siêu hoa VTS110,Sen Vàng Seeds,13520,Hà Lan,"Hoa tươi, Cây cảnh & Hạt giống",13520,0,0
274175357,Máy vặn vít pin Bosch Go 3 (KIT),Bosch,1467000,Trung Quốc,Các loại máy và phụ kiện,1517000,50000,3
274608449,"Sét 100 Túi Màng Bọc Thực Phẩm , Thức Ăn Co Giãn Hàng Loại 1 - Chính Hãng",PaKaSa,29000,Trung Quốc,Phụ kiện nhà bếp,58000,29000,50
275418118,"Giấy Bạc Bọc Thực Phẩm Nướng Thịt, Làm Bánh",NAVIVU,38000,Trung Quốc,Phụ kiện nhà bếp,38000,0,0
201672790,Công tắc thông minh HUNONIC DATIC 3 nút màu trắng - Điều khiển từ xa bằng điện thoại - Công nghệ 4.0,HUNONIC,355000,Việt Nam,Thiết bị điều khiển thông minh,355000,0,0
252276079,Máy đo pH nước và bút đo pH hồ cá với tính năng điều chỉnh ATC thử tính kiềm axit nước chính xác - hàng nhập khẩu,VINETTEAM,79000,Trung Quốc,Thiết bị đo lường,79000,0,0
213876766,"1 Mét Cuộn Keo 2 Mặt Băng Gai Dính Velcro Dán Xé Treo Đồ, Treo Ổ Điện, Treo Tranh Tiện Lợi",NAVIVU,20000,Trung Quốc,,20000,0,0
275855041,Bộ dụng cụ sửa chữa đa năng 40 chi tiết,smatayoko,115000,China,,115000,0,0
137504754,Hạt giống hoa Tóc Tiên Đỏ dây leo VTS176,Sen Vàng Seeds,16536,Hà Lan,"Hoa tươi, Cây cảnh & Hạt giống",16536,0,0
249891731,Đèn led KGRGBGD08 dùng app cảm ứng âm thanh và nhấp nháy theo nhạc tích hợp micro 32led - Hàng chính hãng,KINGO,78000,China,,120000,42000,35
113997350,Ly giấy 10oz~295ml - Lốc 50 ly giấy trơn - Ly trắng_2PE,New Star Paper,34000,Việt Nam,Phụ kiện nhà bếp,34000,0,0
135502760,"Ghế Giám Đốc, Ghế Văn Phòng  AZP FURNITURE Ergonomic AZP-9507 NEW - Nhóm Siêu Êm, Ngả Lưng relax, Style Thời Trang",AZP,3781000,Trung Quốc,"Nội thất phòng học, làm việc",3781000,0,0
274910767,"Bộ Sạc Pin đôi 16850 3,7V Đa Năng 2 Pin - Hàng chính hãng ",PaKaSa,39000,Trung Quốc,Pin và dụng cụ sạc pin,78000,39000,50
275128068,"Set 10 Khay Giấy Bạc/Khuôn Đĩa Nhôm 22cm, dày 70mic  Đựng Thức Ăn, Thực Phẩm Lót Nồi Chiên Không Dầu, Lò Nướng",BIOGREEN,16000,"Anh, Việt Nam",Phụ kiện nhà bếp,16000,0,0
649203,Bộ 6 Ly Thủy Tinh Flora Bormioli Rocco 384420V42021990 (260ml / Ly) - Xanh Lá,Bormioli Rocco,193000,Ý,"Ly, cốc & phụ kiện ly",214000,21000,10
76240783,Bộ 10 Lõi lọc nước số 1 PP 1micron dùng trong máy lọc nước (Hàng chính hãng),SMY,127000,Việt Nam,"Bình lọc, lõi lọc, thiết bị lọc nước",180000,53000,29
275224399,"Cuôn Băng Keo Chống Thấm Nhật Bản Băng Dính Chống Thấm Nước Chống Dột Mái Tôn, Dán Tường Siêu Dính Khổ Rộng 5,10,15,20cm Dài 5m",fofaHome,34000,Trung Quốc,Dụng cụ sửa chữa nhà cửa,49000,15000,31
121689919,"Hộp Bảo Quản Interlock Lock&Lock - INL401W- 620ml Dùng Đựng Đồ Khô, Gia vị",LocknLock,47000,Việt Nam,Dụng cụ chứa đựng thực phẩm,96000,49000,51
204436908,"Rèm Nhà Tắm, Phòng Tắm Polyester Không Thấm Nước Họa Tiết Kẻ Sọc",Rando,250000,Việt Nam,Phụ kiện nhà tắm,250000,0,0
14639229,Nắp Kính Cường Lực Nồi Và Chảo Fivestar,Fivestar,55000,Việt Nam,Phụ kiện nhà bếp,100000,45000,45
106707718,Cục chống va đập cửa vào tường mẫu dán tường Hobby Home Decor CC3,Hobby Home Decor,45000,Trung Quốc,Bảo vệ nhà cửa,59000,14000,24
262734557,"Bình Ga bơm bật lửa, hộp quẹt gas bluesky kèm 5 đầu chuyển đổi",OEM,69000,Hong Kong,"Bếp nướng, vỉ nướng",69000,0,0
147429712,Vòi hoa sen tăng áp Luva VS4- Hàng Chính Hãng,Luva,199000,Việt Nam,Thiết bị phòng tắm,199000,0,0
10142503, Dây Rút Nhựa 1 Tấc (3 x 100mm) - Xanh lá  - 100 sợi,Milliken Tampe,34000,,Dụng cụ sửa chữa nhà cửa,34000,0,0
152816167,Bình Đựng Nước 2L Dễ Thương Có Vạch Báo Giờ Uống Nước Mỗi Ngày Kèm Khăn Lau 2 Mặt BaoAn - Hàng Chính Hãng,BaoAn,88000,Việt Nam,,99000,11000,11
169533164,"Áo Trùm Máy Giặt Cửa Trên Vải Dù Siêu Dày, Size Từ 7kg-15kg, Lựa Chọn Họa Tiết",XUDI,105000,Việt Nam,Phụ kiện giặt ủi,105000,0,0
275356388,"Combo 10 Móc Treo Quần Áo Chống Trượt Xoay 360 Đa Năng Móc Nhựa Cao Cấp Bền Bỉ Chịu Vật Nặng, Mắc Áo Nhựa Giao Màu Ngẫu Nhiên",fofaHome,43000,Trung Quốc,Phụ kiện giặt ủi,72000,29000,40
275220519,"Kệ chữ nhật trong HOKORI khung inox 2 / 3 tầng nhựa VIỆT NHẬT cao cấp đựng đồ đa năng - Văn phòng, vệ sinh, phòng khách - Hàng Việt Nam",Việt Nhật,279000,Việt Nam,,558000,279000,50
182739568,VÕNG XẾP DUY LỢI INOX -  CỠ ĐẠI (QUÀ TẶNG 10 MÓC ÁO KÉP NHỰA CAO CẤP DUY LỢI),Duy Lợi,1748000,Việt Nam,Phụ kiện phòng ngủ,1748000,0,0
198192347,"Lót Ly Ceramic Trắng Trơn, Đế Lót Cốc Gốm Sứ Siêu Thấm Hút, Thích Hợp Trang Trí DIY - Chính Hãng NAVIVU",NAVIVU,20000,Việt Nam,"Ly, cốc & phụ kiện ly",20000,0,0
14323807,Túi đựng chăn màn khung sắt - màu cơ bản/giao ngẫu nhiên,OEM,55000,,Phụ kiện phòng ngủ,63000,8000,13
114789036,Vòi Dẫn Nước Rửa Chén Bộ Đầu Vòi Dẫn Bơm Hút Xịt Nước Rửa Chén Dầu Rửa Bát Gắn Bồn Rửa Bát,OEM,58000,Việt Nam,Phụ kiện nhà bếp,79000,21000,27
96867829,Hạt giống Bầu Sao F1 giống khỏe trái sai VTS155,Sen Vàng Seeds,14456,Thái Lan,"Hoa tươi, Cây cảnh & Hạt giống",14456,0,0
275869663,Đèn bàn LED bảo vệ thị lực RD-RL-38.LED-4000K 6W- Màu ngẫu nhiên,Rạng Đông,164000,Việt Nam,Đèn học và đọc sách,304000,140000,46
173711516,Ly Giữ Nhiệt Inox Có Quai Cầm Hàng Cao Cấp - PaKaSa,PaKaSa,86000,Việt Nam,Bình/ Ly giữ nhiệt,144000,58000,40
2240467,Combo 5m Decal Giấy Dán Kính Hoa Bồ Công Anh (5mx0.45m),OEM,47500,Trung Quốc,Decal & giấy dán kính,50000,2500,5
275379188,"Bộ 2 bàn chải nhà tắm , Bàn chải uốn cong giúp vệ sinh trên mọi bề mặt dễ dàng PaKaSa - Giao màu ngẫu nhiên",PaKaSa,49000,Trung Quốc,Dụng cụ vệ sinh,98000,49000,50
21878574,Gương soi cao cấp KIBATH KB201,KIBATH,270000,Việt Nam,,270000,0,0
193685318,Bộ Quần Áo Mưa Yamaha,Yamaha,957000,Việt Nam,"Áo mưa, ô dù và phụ kiện đi mưa",957000,0,0
186555776,"Combo 5 Miếng Dán Chữ U Đa Năng Treo Ổ Điện, Treo Hộp Giấy",NAVIVU,15000,Việt Nam,,15000,0,0
271064633,Đũa Gỗ Hồng Vương Triều Trung Hoa Vỉ 5 Đôi Kokusai NDCK-28,Kokusai ,86000,Trung Quốc,"Đũa, muỗng, nĩa",172000,86000,50
46207255,Combo 2 túi lưới giặt đồ 2 lớp Polyester dạng lưới mịn giặt đồ chống biến dạng quần áo cho máy giặt dạng hộp khóa kéo phù hợp giặt đồ nhỏ đồ lót,OEM,68000,Trung Quốc,Phụ kiện giặt ủi,68000,0,0
275224464,Áo Mưa Mẹ Và Bé Nửa Trước Trong Suốt Che Phủ Toàn Thân Kèm Kính Chắn Mưa Cực Kỳ Tiện Lợi Loại 1 Đầu Giao Màu Ngẫu Nhiên ,fofaHome,81000,Trung Quốc,"Áo mưa, ô dù và phụ kiện đi mưa",110000,29000,26
275888864,"Gối Tựa Đầu Ghế Văn Phòng, Gối Kê Cổ Cao Su Non, Ngàm Khóa Cố Định Trên Ghế Giảm Mỏi Vai Gáy- Sairui",sr LIFE EXPERTS SAIRUI,339000,Trung Quốc,"Gối, ruột gối, vỏ gối",400000,61000,15
73617595,"Ống Đựng Đũa Inox 304 Treo Tường Cao Cấp Chính Hãng GAGI Mã GD01 Không Gỉ Sét, Có Thể Để Bàn (2 in 1)",SPEVI,260400,Việt Nam,Phụ kiện nhà bếp,304000,43600,14
275821557,Chế phẩm trừ bọ trĩ và rệp sáp CONFIDOR 200SL 20ml,Dudaco,56000,Việt Nam,"Hoa tươi, Cây cảnh & Hạt giống",56000,0,0
118102419,"2 Kệ Treo Tường Màu Vân Gỗ Sồi, Gỗ Dày 25mm Để Được Đồ Nặng Với Kết Cấu Không Giá Đỡ Thẩm Mỹ Thương Hiệu SIB Decor",SIB DECOR,293000,Việt Nam,Nội thất phòng khách,350000,57000,16
169536766,"Áo Trùm Máy Giặt Cửa Trên 12kg-15kg Vải Dù Siêu Dày, Lựa Chọn Họa Tiết",XUDI,105000,Việt Nam,Phụ kiện giặt ủi,105000,0,0
275321685,Dây nối dài cho đèn năng lượng mặt trời Vạn Năng Solar,Vạn Năng Solar,50000,Trung Quốc,Bóng và linh kiện đèn,50000,0,0
649242,Bộ 6 Ly Thủy Tinh Naos Bormioli Rocco 530334B45321990 (295ml / Ly) - Hồng,Bormioli Rocco,337000,Ý,"Ly, cốc & phụ kiện ly",389000,52000,13
75836319,"Phân bón hữu cơ Kích Hoa cho Hoa hồng, Hoa lan, cây cảnh, cây kiểng trong nhà và ngoài trời, giàu lân giúp phân nhánh nụ, hoa, giảm chồi điếc, dung tích 1 lít, chính hãng DOCNEEM",DocNeem,119000,Việt Nam,"Hoa tươi, Cây cảnh & Hạt giống",119000,0,0
15243086,Hộp đựng giấy vệ sinh gắn tường inox 304 siêu bền,Hando,238000,,Phụ kiện nhà tắm,238000,0,0
248166684,Kệ Giày Kệ Để Đồ Chia Nhiều Ngăn Nhỏ Gọn Tiện Lợi MDF Chắc Chắn - AP247,HAJI OFFICIAL,206000,Việt Nam,Nội thất phòng khách,356000,150000,42
194817539,Đèn Pin Mini Có Zoom Siêu Sáng Đầu Sạc Usb Hợp Kim Nhôm - Chính Hãng,Gro-Fa,91000,Trung Quốc,,91000,0,0
192687668,"Mền ngủ văn phòng hình thú cao cấp A được chọn màu - mền đắp chân mỏng nhẹ, gấp gọn tiện lợi",A,65000,Việt Nam,"Chăn, mền và phụ kiện",75000,10000,13
104557047,   Ổ cắm Điện Quang ĐQ ESK 5W.SM750SL (5 lỗ 3 chấu dây 5 mét màu Trắng Đỏ),Điện Quang,202000,Việt Nam,"Ổ cắm, ổn áp, biến áp",202000,0,0
205299206,Áo bọc Bàn để ủi quần áo Nakagami kích thước 30x80 - 30x90 cm - Màu ngẫu nhiên,Nakagami,54000,Việt Nam,Phụ kiện giặt ủi,54000,0,0
192275220,Combo 6 xiên cán gỗ inox 304 nướng thịt,Landmann,80000,Việt Nam,Phụ kiện nhà bếp,80000,0,0
206952469,"Xô Nhựa Gấp Gọn 5L Tiện Dụng GroFa - Hàng chính hãng , giao màu ngẫu nhiên ",Gro-Fa,78000,Trung Quốc,Phụ kiện nhà tắm,78000,0,0
221515196,"Kệ gương KG69 dùng cho phòng tắm để xà bông, mỹ phẩm đa năng dễ tiện lợi, kính cường lực chống xước inox304 cao cấp (500x120x10mm)- Hàng chính hãng",KINGO,94000,Việt Nam,,115000,21000,18
242620833,"Muỗng Inox, Bộ Thìa Dĩa/Nĩa Inox 304 Cao Cấp SMARTCHOICE ( SET 6 CÓ HỘP ) - Hàng Loại 1 Siêu Dày Dặn, Bền Đẹp, Muỗng Inox Ăn Cơm Cán Dài Sang Trọng",SmartChoice,199000,Trung Quốc,"Đũa, muỗng, nĩa",199000,0,0
649403,Bộ 6 Ly Thủy Tinh Diamond Bormioli Rocco 350260M02321990 (470ml / Ly) - Xanh Biển,Bormioli Rocco,523000,Ý,"Ly, cốc & phụ kiện ly",605000,82000,14
262303191,Miếng Bọt Biển Tẩy Rửa Nano Melamine Foam Ma Thuật - Cọ đến đâu sạch đến đó không cần xà phòng,NAVIVU,5200,Nhật Bản / Trung Quốc,Phụ kiện nhà bếp,5200,0,0
274338308,Máy đánh trứng KG86 tạo bọt cà phê mini cầm tay dễ sử dụng 2 trong 1 tích hợp cổng sạc usb - Hàng chính hãng ,KINGO,95000,China,Phụ kiện phòng ăn,120000,25000,21
121262278,Bộ tuốc nơ vít 6 in 1 Crownman 0606001 - Hàng Chính Hãng,Crownman,102000,Việt Nam,Các loại máy và phụ kiện,120000,18000,15
274944710,"SET 100 tờ giấy gói bánh mỳ, hamburger, sandwich kích thước 30x30cm hàng cao cấp, không thấm dầu mỡ",BIOGREEN,44000,Việt Nam,Dụng cụ làm bánh,44000,0,0
274528345,"Hộp Đựng Giấy Vệ Sinh 2 tầng có kệ để diện thoại dán tường chất liệu ABS + PP cao cấp chống nước có ngăn kéo để đồ và kệ để điện thoại, Kệ treo tường đa năng Kitchen",Lucky,75000,Nhật Bản / Việt Nam,,100000,25000,25
54841005,Set kẹp treo quần áo inox,OEM,40000,Việt Nam,Phụ kiện giặt ủi,40000,0,0
275510019,Vợt Muỗi Kiêm Máy Bắt Muỗi Cao Cấp Có Đế Sạc,NAVIVU,250000,Trung Quốc,"Dụng cụ diệt chuột, côn trùng",250000,0,0
190755054,"Hạt Giống Bạc Hà Âu Greenhome, Gói 0,1gr, Húng Lũi Dễ Trồng Quanh Năm, Nảy Mầm Cao, Thu Hoạch Nhanh, Năng Suất Cao G02",SENVANG SEEDS,8900,Việt Nam,"Hoa tươi, Cây cảnh & Hạt giống",8900,0,0
192154540,"Đèn tường, đèn cầu thang hắt 2 đầu chống nước hiện đại 3 chế độ sáng trang trí cổng, phòng ngủ",Goldseee,295000,Việt Nam,,295000,0,0
92959710,"Chuông Điện dạng đĩa 6 inches, 85dB - 220V AC- Tiến Thành, sx tại Việt Nam",TPE,207000,Việt Nam,Bảo vệ nhà cửa,207000,0,0
204046621,Kệ Gia Vị Để Bàn Nhà Bếp - Kệ Gia Vị Khung Sắt Sơn Tĩnh Điện,Ánh Dương,149000,Việt Nam,,149000,0,0
273157366,Thảm lau chân KG08 chất liệu silicon siêu thấm hút nước chống trơn trượt cao cấp đế cao su chất siêu dày 60cm- Hàng chính hãng,KINGO,55000,Việt Nam,Phụ kiện nhà tắm,90000,35000,39
650628,Bộ 6 Ly Thủy Tinh Rock Bar Bormioli Rocco 517530BN1321990 (270ml / Ly),Bormioli Rocco,286000,,"Ly, cốc & phụ kiện ly",331000,45000,14
190792591,"Bộ Sạc pin AA AAA Beston C9024L 8 khe, mẫu mới 2022 sạc nhanh, tự ngắt khi đầy, đèn LED báo thông minh",BESTON,222000,Trung Quốc,Pin và dụng cụ sạc pin,222000,0,0
275336711,Kệ đựng đồ đa năng 3 tầng có bánh xe dễ dàng di chuyển,Nhà của Mẹ,361000,Việt Nam,Phụ kiện giặt ủi,380000,19000,5
142419792,Bình Giữ Nhiệt Lưỡng Tính Tiger MCX-A602 (600ml),Tiger,529000,Việt Nam,Bình/ Ly giữ nhiệt,529000,0,0
250364790,"Bảng lỗ Pegboard Dola Home kim loại cao cấp treo tường. Phù hợp đặt ở góc làm việc, trang trí nhà cửa",Dola Home,324000,Việt Nam,"Nội thất phòng học, làm việc",329000,5000,2
20735370,Nhang Xanh Đàn Hương - 30cm - 500 cây - 500g - Bột gỗ từ Ấn Độ - Nhang Thiền ,Nhang Xanh,234000,Việt Nam,,260000,26000,10
202761634,"Bộ tượng 5 chú mèo may mắn thích hợp để trang trí bàn học, làm việc, cửa hàng hoặc xe hơi - Chính hãng HENRYSA",HENRYSA Bạn của mọi nhà,125000,Trung Quốc,Trang trí nhà cửa khác,180000,55000,31
139732211,Túi Zipper Kokusai đựng thực phẩm đa dụng TZIP59004626,Kokusai ,28300,Nhật Bản,Dụng cụ chứa đựng thực phẩm,55500,27200,49
59410891,"Gối hơi du lịch, gối tựa cổ đa năng tự bơm, chọn màu theo ý+ Tặng kèm thẻ đeo hành lý, giao mẫu ngẫu nhiên",ST SOHOGO,79000,Trung Quốc,"Gối, ruột gối, vỏ gối",79000,0,0
56522542,Bộ 5 ly làm đá inox Rainy từ 7cm đến 10cm,Rainy,100440,Việt Nam,Phụ kiện nhà bếp,108000,7560,7
119203579,"Kính bảo hộ UVEX PHEOS CX2 9198237 kính chống bụi, chống hơi nước trầy xước vượt trội, ngăn chặn tia UV, mắt kính đi xe",UVEX,245000,Đức,,245000,0,0
270856023,Phễu Pha Cà Phê Nhựa Cứng Màu Hario V60 Coffee Dripper,Hario,94600,Nhật Bản / Trung Quốc,"Bình, ly uống cà phê và phụ kiện",94600,0,0
198198076,"Móc Inox Treo Cây Lau Nhà Dán Tường 2 trong 1 ECODEALS - Cứng cáp, chịu tải cao, inox không gỉ sang trọng",ECODEALS,34000,Đài Loan,,47000,13000,28
107982436,"Bộ 2 cây chổi cọ toilet, nhà vệ sinh - Nhật Bản",Kokubo,94500,Nhật Bản,Dụng cụ vệ sinh,94500,0,0
275767199,"Đèn Năng Lượng Mặt Trời, Đèn Solar 100 Led, Siêu Sáng, Chống Nước, Đèn Trang Trí Ngoài Cửa, Sân Vườn",HT SYS,77000,Trung Quốc,Đèn ngoài trời,77000,0,0
177467255,Khóa tay nắm gạt cửa toilet Hafele - 911.63.226,HAFELE,484000,Trung Quốc,Bảo vệ nhà cửa,484000,0,0
125240745,"Màng lọc âm chắn gió Dr.MIC Pop Shield P01 - Cho Micro Thu Âm, Mic LiveStream Microphone P-01 Hàng Chính Hãng - Kèm Móng Gẩy DreamMaker",Dr.MIC,60000,Trung Quốc,Phụ kiện nhạc cụ,60000,0,0
274910795,Bộ Tua Vít Sửa Chữa Đa Năng 27 Món - Hàng Chính Hãng,PaKaSa,134470,Trung Quốc,,202000,67530,33
89518724,Thùng Rác Đạp Chữ Nhật Hiro 10L-15L-20L-30L,Inochi,269000,Việt Nam,Dụng cụ vệ sinh,269000,0,0
152097709,Thùng 24 hộp giấy bạc nướng Ringo,RINGO,300000,Việt Nam,Phụ kiện nhà bếp,300000,0,0
146942933,"Van phao cấp nước cho bộ xả bồn cầu, dùng được cho các loại bồn cầu có két nước - DALICO",OEM,57000,Việt Nam,Thiết bị phòng tắm,60000,3000,5
75411116,"Lót chân ghế, miếng dán chống trầy, chống rung lắc bàn ghế - Hàng chính hãng",MO hi,22500,Trung Quốc,Bảo vệ nhà cửa,25000,2500,10
191378519,"Nhang Sạch Tùng Bách MỘC LÂM 400cây 38cm, Ít Khói Tự Nhiên, Hương Thơm SIÊU NHẸ - SIÊU DỄ CHỊU",mộc lâm,108100,Việt Nam,,115000,6900,6
134827602, Pin trung C Duracell MN1400-LR14 Alkaline Last Longer - Vỉ 2 viên,DURACELL,85000,Việt Nam,Pin và dụng cụ sạc pin,85000,0,0
241980823,"Combo 20 Kẹp Inox 304 Phơi Quần Áo, Chăn Mền",Jodily StarHome,15000,Hàn Quốc / Trung Quốc,Phụ kiện giặt ủi,15000,0,0
275205267,"Bộ 4 lọ gia vị có thìa muỗng nhựa Việt Nhật - Hũ đựng gia vị có nắp đậy, có khay đế (Màu ngẫu nhiên)",Việt Nhật,49000,Việt Nam,Dụng cụ chứa đựng thực phẩm,75000,26000,35
262023053,Kệ đựng đũa muỗng dao thớt đa năng inox 304 Hobby Home Decor KDMT4,Hobby Home Decor,312550,Trung Quốc,,469000,156450,33
110041811,Hạt giống hoa Cúc Sao Băng vàng VTS167,Sen Vàng Seeds,16536,Hà Lan,"Hoa tươi, Cây cảnh & Hạt giống",16536,0,0
249577189,"Lồng Phơi Thực Phẩm, Phơi Cá Khô Chống Ruồi Muỗi, Côn Trùng Bằng Lưới PE Dễ Dàng Vệ Sinh,Thu Gọn - HÀNG CHÍNH HÃNG MINIIN",MINIIN,68000,Trung Quốc,"Dụng cụ diệt chuột, côn trùng",79000,11000,14
60389920,"Nhang sen thuần khiết Liên Tâm 20.5cm - 160 cây - hương sen, 100% thiên nhiên, ít khói, mùi dịu nhẹ, dùng cho chung cư, phòng máy lạnh",Liên Tâm,70000,Việt Nam,,70000,0,0
204627195,Lót ghế văn phòng Tấm lót ghế vuông hạt gỗ Thông cao cấp KT 45x45cm hạt 18li dùng cho ghế văn phòng,DAICAT,169550,Việt Nam,"Nội thất phòng học, làm việc",189000,19450,10
54707710,Túi Đựng Hộp Cơm Giữ Nhiệt Đa Lớp Nhiều Hoa Văn - Denim Lá Thông,OEM,40000,Trung Quốc,Bộ hộp cơm và phụ kiện,40000,0,0
273900154,Gói 5 Miếng Rửa Chén Bát Xoong Nồi - Nội địa Nhật Bản Mẹ và Bé Unmei ,Kokubo,48000,Nhật Bản,Phụ kiện nhà bếp,48000,0,0
215462168,Sen cây tắm nóng lạnh Frap F2428 - Hàng Chính Hãng LIÊN BANG NGA,Frap,2485000,Nga,Thiết bị phòng tắm,4700000,2215000,47
515637,Hộp Bảo Quản Interlock Lock&Lock - INL302W - 1.0L,LocknLock,57000,Việt Nam,Dụng cụ chứa đựng thực phẩm,89000,32000,36
3702471,Dao chặt SEKI Japan cao cấp hàng Nhật Bản,Seki,305500,Nhật Bản,"Dao, kéo và phụ kiện",310500,5000,2
275842322,"Găng Tay Làm Vườn Phủ PU Chống Tĩnh Điện, Chống Bụi, Chống Trượt",NAVIVU,40000,Trung Quốc,Dụng cụ làm vườn,40000,0,0
70841327,Pin Energizer Specialty ECR2032 Vỉ 5 Viên,Energizer,60000,Indonesia,Pin và dụng cụ sạc pin,64600,4600,7
275189054,"Combo 5 Giá Treo Ổ Cắm Điện, Modem Dán Tường Tiện Dụng PaKaSa - Hàng Chính Hãng",PaKaSa,59000,Trung Quốc,,118000,59000,50
274364548,"Giỏ Đựng Khăn Giấy Nhà Bếp, Giấy Nhà Vệ Sinh Việt Nhật - Giao ngẫu nhiên",PEAFLO,25000,Việt Nam,Thiết bị phòng tắm,25000,0,0
275239424,03 Cuộn Túi Đựng Rác Màu Tự Hủy Nặng 1kg,PEAFLO,52000,Việt Nam,Dụng cụ vệ sinh,52000,0,0
21482309,Băng keo chống thấm  khổ 10cm x10m,OEM,49000,,Dụng cụ sửa chữa nhà cửa,49000,0,0
270651335,Gối Ngủ Chống Đau Mỏi Vai Gáy Gối Spa Êm Chống Đau Cổ - Gối Chống Ngáy Giảm Mệt Mỏi,fofaHome,82000,Trung Quốc,"Gối, ruột gối, vỏ gối",129000,47000,36
173302805,"Đèn Bàn Học ,Đọc Sách, Đèn Ngủ Cao Cấp  LED Chống Cận 03 Chế Độ Ánh Sáng Bảo Vệ Mắt -KOVER (tặng dây cáp sạc pin)",KOVER,56000,Đài Loan,Đèn học và đọc sách,56000,0,0
262881547,Gối ôm đắp vịt Hometex,Hometex,105000,Việt Nam,"Gối, ruột gối, vỏ gối",105000,0,0
3325393,Đèn Diệt Côn Trùng Đại Sinh DS-D82 (trắng),Đại Sinh,1149000,Việt Nam,,1149000,0,0
19419720,Bình đựng nước 1l Nakaya nội địa Nhật Bản,NAKAYA,32000,Nhật Bản,,32000,0,0
263705367,"[CHỌN MÀU-VẢI NHUNG]-KÈM TÚI-Gối hơi kê cổ bơm tự động, mềm mại, thiết kế hình chữ U giúp giảm đau cổ, có nút cài, phù hợp cho văn phòng và du lịch",SOHOGO,59000,Trung Quốc,"Gối, ruột gối, vỏ gối",59000,0,0
73531849,Combo 03 Set túi Zip bảo quản thực phẩm - Nội địa Nhật Bản,Pearl Metal,118500,Nhật Bản,Dụng cụ chứa đựng thực phẩm,118500,0,0
199271394,"Đèn Led Neon Bông Tuyết Cỡ Lớn 40cm Trang Trí Giáng Sinh, Năm Mới -  Chính Hãng NAVIVU",NAVIVU,120000,Trung Quốc,,120000,0,0
33507146,Đèn LED Chiếu sáng Khẩn cấp Rạng Đông Model: D KC02 10W,Rạng Đông,568720,Việt Nam,,710900,142180,20
76273442,Hộp Bảo Quản Interlock Lock&Lock - INL304W - 700Ml - Nhựa Pet,LocknLock,58000,Việt Nam,Dụng cụ chứa đựng thực phẩm,89000,31000,35
63102936,"Kính bảo hộ mắt chuyên dụng chống hóa chất, bụi và chống tia UV 3M 3M-334",3M,55000,Trung Quốc,Bảo hộ lao động,55000,0,0
176714643,Bộ 100 Túi Màng Bọc Thực Phẩm Thông Minh PE An Toàn Túi Gấu Có Chun Bọc Đồ Ăn Co Giãn Siêu Dai Cao Cấp Chính Hãng Amalife,Amalife,25000,Trung Quốc,Dụng cụ chứa đựng thực phẩm,25000,0,0
155640558,Nồi Luộc Gà Inox 3 Đáy Sunhouse SH28LG,Sunhouse,407440,Việt Nam,Nồi và chảo,660000,252560,38
154589094,Bộ 3 Khuôn Xôi Phúc Lộc Thọ - Khuôn Làm Bánh Đồ Xôi Bằng Nhựa PP An Toàn Tiện Lợi - Hàng Loại 1,MINIIN,72200,Việt Nam,Dụng cụ làm bánh,76000,3800,5
155272007,"Kệ để giày dép inox 5 tầng chính hãng DODODIOS, giá để giày inox 5 tầng - Chọn Màu",dododios,118000,China,Nội thất phòng khách,118000,0,0
246164532,"Hộp cơm cắm điện Bear DFH-P09D1, 1.0 lít, nấu chín, hâm nóng và giữ nhiệt cho thức ăn, dùng inox 304",Bear,494000,Trung Quốc,Bộ hộp cơm và phụ kiện,618000,124000,20
69020872,"Tời Quay Tay ABG 800LBS 363Kg - Máy Tời Xoay Cầm Tay Chuyên Dùng Để Nâng Hạ Hàng Hóa , Máy Móc - Hàng Chính Hãng",ABG,384000,Trung Quốc,,384000,0,0
275402591,Bẫy Bắt Chuột Thông Minh - Dễ Sử Dụng - Hiệu Quả Cao - Không Độc Hại - HENRYSA,HENRYSA Bạn của mọi nhà,38000,China,"Dụng cụ diệt chuột, côn trùng",50000,12000,24
275074308,Cuộn Băng Keo Chống Thấm Chống Dột Mái Tôn X2000 Siêu Dính,PEAFLO,49000,Trung Quốc/Hàn Quốc/Mỹ/Thái Lan/Nhật Bản (tùy vào đợt hàng),Dụng cụ sửa chữa nhà cửa,65000,16000,25
275354923,Nệm PE Hàn Quốc Cao Cấp Gấp 3 ( 1m2 x 1m95 x 3cm) Giao Màu Ngẫu Nhiên - Tặng Kèm Cặp Áo Gối,KINGROLL MATTRESS R,219000,Việt Nam,Nệm và phụ kiện,270000,51000,19
270060676,Bình đựng nước Lock&Lock dung tích 1.5L dùng trử nước trong tủ lạnh P-00097,LocknLock,40000,Việt Nam,,65000,25000,38
275798562,Van chia nước 2 đầu vặn cho dây cấp inox 304 Hobby home decor DNV2,Hobby Home Decor,149000,Trung Quốc,Dụng cụ làm vườn,209000,60000,29
273162727,"BỘ VÒI TƯỚI TỰ ĐỘNG THU DÂY -20m: Kèm đầu phun 7 cấp, tiện dụng & bền bỉ.Sang trọng - Bền Bỉ - Hiệu quả tối ưu.Tặng kèm đầu phun 9 cấp độ. Số lượng có hạn",OEM,1212500,Trung Quốc,Dụng cụ làm vườn,1500000,287500,19
275137241,"Miếng Bọt Biển Lau Kính, Tẩy Sạch Cặn Canxi Trên Đồ Inox",NAVIVU,40000,Trung Quốc,Dụng cụ vệ sinh,40000,0,0
91062932,Hạt Giống Hoa Bất Tử Nhiều Màu Rạng Đông 20 hạt - Shop Hạt Giống Ba Miền Chịu Nhiệt,Rạng Đông,13000,Việt Nam,"Hoa tươi, Cây cảnh & Hạt giống",23400,10400,44
274653881,"Túi 100 Dây Rút Nhựa, Lạt Nhựa Đủ Kích Cỡ , Siêu Bền Để Làm Vườn, Thi Công Tiện Lợi - Hàng chính hãng",Gro-Fa,19000,Trung Quốc,Dụng cụ sửa chữa nhà cửa,19000,0,0
274609200,"Bút thử nước sạch cao cấp, dụng cụ đo TDS, đo độ cứng của nước",Gubix,90000,"Anh, Việt Nam",Thiết bị đo lường,90000,0,0
275657861,Gối Cổ Giảm Âm 4The - Noise Cancelling Pillow | Gối Cổ Du Lịch Cao Cấp Thoải Mái | 3 Màu Sắc,Ru9,699300,Việt Nam,"Gối, ruột gối, vỏ gối",999000,299700,30
55459728,Kéo Nhật đa năng -Hàng cao cấp,OEM,39000,Nhật Bản,"Dao, kéo và phụ kiện",39000,0,0
274128511,"KÌM CẮT CÁP ĐIỆN ĐẦU LỚN 10"" TOTAL THT1151021   - HÀNG CHÍNH HÃNG",Total,117612,China,Dụng cụ sửa chữa nhà cửa,117612,0,0
275437142,"BỘ 3 RON CAO SU DÙNG CHO TẤT CẢ MÁY XAY SINH TỐ 8CM VÀ 8,5CM (BẢN DẸP)",Rainy,35000,Trung Quốc,Phụ kiện nhà bếp,35000,0,0
52872291,Áo Choàng Tắm Khách Sạn Cao Cấp,OEM,207575,Việt Nam,Phụ kiện nhà tắm,230000,22425,10
110350637,Ga Giường Drap Lẻ Phi Lụa Lavish Silk cao cấp mát lạnh hàng loại 1 không nối vải - Vàng Đồng,LAVISH SILK,299000,Việt Nam,,299000,0,0
273872854,Kéo SK5 Nhật Bản Cắt Thịt Gà Và Cắt Đồ Siêu Bền,PEAFLO,52000,Thái Lan / Trung Quốc / Malaysia (Tùy từng đợt nhập hàng),"Dao, kéo và phụ kiện",52000,0,0
273703650,"Đèn Để Bàn, Đèn Học Chống Cận Xoay 360 - Kèm Kẹp Bàn chống xê dịch và bóng đèn",PEAFLO,239000,HK/TQ,Đèn học và đọc sách,239000,0,0
5750351,Combo Trống Lắc Tay Và Bao Đựng Lục Lạc Gõ Bo Tambourine Yamaha MT6-102B (Xanh),Yamaha,274000,Trung Quốc,Bộ Trống - Drum,274000,0,0
111410844,"Găng tay bảo hộ lao động Jogger Superpro - Bao tay lao động chống dầu nhớt, trơn trượt, độ linh hoạt cao - Chính hãng",Safety Jogger,21900,Trung Quốc,Bảo hộ lao động,21900,0,0
17488465,Vỉ 5 viên Pin GP 12V 23A,GP,45000,Trung Quốc,Pin và dụng cụ sạc pin,45000,0,0
276285253,Túi Vải Canvas đặc biệt Đựng Ly Giữ Nhiệt Commuter 1180ml tiện lợi đi học đi làm đi chơi - ELEMENTAL,Elemental,85000,Mỹ,"Ly, cốc & phụ kiện ly",85000,0,0
275357336,"Chai xịt giặt khô quần áo, giày dép Lion Hàn Quốc 500ml làm sạch siêu tốc, an toàn",Showermate,175000,Hàn Quốc,Phụ kiện giặt ủi,175000,0,0
199752781,"Dụng cụ cố định dây sạc, dây điện bằng silicon dùng keo dán 2 mặt 3M, giao màu ngẫu nhiên",FuNu,57000,Trung Quốc,Dụng cụ sửa chữa nhà cửa,60000,3000,5
190755080,"Hạt Giống Cải Bẹ Xanh Mỡ Greenhome, Gói 20g, Dễ Trồng Quanh Năm, Nảy Mầm Cao, Thu Hoạch Nhanh, Năng Suất Cao R04",SENVANG SEEDS,10900,Việt Nam,"Hoa tươi, Cây cảnh & Hạt giống",14220,3320,23
76254098,"Ruột Chăn Hè Thu Lidaco Chần Bông Bông Trắng Tinh Khiết Kích Thước 2mx2,2m",LIDACO,209000,Việt Nam,"Chăn, mền và phụ kiện",280000,71000,25
275066081,Bộ tô vít đa năng chuyên dụng 32 món có hộp đựng - Hàng chính hãng ,Gro-Fa,49000,Trung Quốc,,49000,0,0
274042693,"Ô dù tự động đóng mở siêu nhẹ cao cấp Nason Smoothy, đóng lại chỉ cần 1 ngón tay vải cao cấp chống nắng, tia UV",Nason Umbrella,274550,Việt Nam,"Áo mưa, ô dù và phụ kiện đi mưa",450000,175450,39
24857285,Đầu Vòi Xịt Nước Tăng Áp Xoay 360 Độ Cho Vòi Bồn Rửa Turbo Flex Loại Cao Cấp,OEM,25000,,Phụ kiện nhà bếp,25000,0,0
48045630,5 Viên Pin Smartkey - Cmos Panasonic CR2032 - Hàng Chính Hãng,Panasonic,65000,Thái Lan/ Indonesia/Trung Quốc,Pin và dụng cụ sạc pin,65000,0,0
101904812,Mắt thần gắn cửa phòng chống trộm đường kính 16mm HOBBY Home Decor MT1,Hobby Home Decor,65000,Trung Quốc,Bảo vệ nhà cửa,99000,34000,34
271064510,Bình nước thể thao Lafonte - 452089 - BLU,La Fonte,59300,Trung Quốc,,115000,55700,48
274789792,Combo 30 Miếng Dán Chân Ghế Hình Tròn PaKaSa - Hàng chính hãng ,PaKaSa,25000,Trung Quốc,"Nội thất phòng học, làm việc",50000,25000,50
56731480,Bộ 5 khớp nối vòi xịt rữa xe tưới cây TOTAL THHCS05122,Total,60000,Trung Quốc,Dụng cụ làm vườn,60000,0,0
69500507,Áo mưa cánh bướm trẻ em Rando Pocho dành cho các bé có độ tuổi từ (2 tuổi đến 12 tuổi) tương đương với các size từ số 1 đến số 5,Rando,59000,Việt Nam,"Áo mưa, ô dù và phụ kiện đi mưa",59000,0,0
191807379,HỘP ĐỰNG TRÀ INOX 304 | LỌ ĐỰNG CHÈ SIÊU BỀN CHỐNG BÁM VÂN TAY | LỌ ĐỰNG 2 LẠNG CHÈ,CRYSTAN,115000,Việt Nam,Phụ kiện phòng ngủ,115000,0,0
529249,Bình Ắc Quy Khô 6V 5Ah Kentom (Đen),Kentom,115000,Việt Nam,,115000,0,0
77705631,ĐÈN LED DÂY THÔNG MINH YEELIGHT LIGHTSTRIP PLUS 1S – BẢN GLOBAL - Nâng Cấp 2020 Hỗ trợ Apple Homekit,Yeelight,539000,Trung Quốc,,785000,246000,31
140573025,"Thảm lau chân Silicon Hình Elip lót cửa chùi chân, siêu thấm hút, chống trượt cho phòng tắm (60x40cm)",OEM,75000,Hàn Quốc,Phụ kiện nhà tắm,75000,0,0
217427325,"Phân Bón Neem Cake Greenhome, Bao 1kg, Hữu Cơ, Trị Cuốn Chiếu, Sùng Đất, Ốc Sên, Hỗ Trợ Kích Rễ, Hoa Hồng, Rau, Cây Cảnh",Greenhome,40900,Ấn Độ,"Hoa tươi, Cây cảnh & Hạt giống",65000,24100,37
122092238,"Máy Xay Tiêu Cầm Tay Tự Động Chạy Pin Kunbe - Cối Xay Hạt Gia Vị Có Đèn Led, Lõi Mài Gốm Ceramic Cao Cấp, Tiện Dụng",KUNBE,185000,Trung Quốc,Phụ kiện nhà bếp,185000,0,0
189558569,"Bộ nồi nhôm chống dính Elmich EL-4101OL size 16,20,24cm",Elmich,990000,Việt Nam,Nồi và chảo,1790000,800000,45
272839409,"Thùng Gạo Thông Minh Tự Động 10Kg OFFICE CHILL, Thùng Đựng Gạo, Thực Phẩm Vật Liệu Nhựa An Toàn Cho Sức Khỏe Bảo Hành 1 Năm",Office Chill,310000,Nhật Bản / Trung Quốc,,320000,10000,3
649263,Bộ 6 Ly Thủy Tinh Naos Bormioli Rocco 530335B45321990 (295ml / Ly) - Xanh,Bormioli Rocco,337000,Ý,"Ly, cốc & phụ kiện ly",389000,52000,13
176251143,"Áo Mưa Bít Trẻ Em Cho Bé Từ 7-10 Tuổi , Áo Mưa Trùm Trẻ Em Che Kín Người An Toàn ( Size 9)",XUDI,95000,Việt Nam,"Áo mưa, ô dù và phụ kiện đi mưa",95000,0,0
142368247,Bình Giữ Nhiệt Lưỡng Tính Tiger MCX-A502 (500ml),Tiger,499000,Việt Nam,Bình/ Ly giữ nhiệt,499000,0,0
30147573,"Chai Xịt Diệt Muỗi , Kiến , Gián, Côn Trùng,.. Thảo Mộc 10s 500ml (Mùi Sả Chanh) - An toàn cho trẻ em và người lớn- Được bộ y tế cấp phép",Thảo Mộc 10S,143000,Việt Nam,"Dụng cụ diệt chuột, côn trùng",143000,0,0
74208914,"Nút Silicon Chống Va Đập Cửa, Miếng Chặn Cửa Họa Tiết Hoạt Hình 3D, Giảm Ồn, Chống Shock, Chống Trầy Xước Và Bảo Vệ Tường KUNBE",KUNBE,11000,Việt Nam,Bảo vệ nhà cửa,11000,0,0
275205384,"Khởi đông từ, contactor Chint 25A/63A 220V",HUNONIC,85000,China / Vietnam,"Ổ cắm, ổn áp, biến áp",85000,0,0
225272712,"Két sắt mini hình cuốn sách TiMa.lala, két sắt bảo mật có khóa đi kèm - giao màu ngẫu nhiên - Hàng chính hãng",TiMa.lala,115000,Trung Quốc,Nội thất phòng ngủ,159000,44000,28
74256757,Hạt giống rau mầm củ cải trắng gói 100g VTS119,Sen Vàng Seeds,20696,New Zealand,"Hoa tươi, Cây cảnh & Hạt giống",20696,0,0
275251619,"Đồng hồ kềm đo điện ampe AC kỹ thuật số TOTAL TMT42002 - độ chính xác cao, màn hình LCD 2000 số đếm, có đèn nền ban đêm, có kèm pin",Total,290000,Trung Quốc,Thiết bị đo lường,329000,39000,12
207801137,"Nước lau sàn chuyên dụng Omo Roborock - Dành cho Robot, Máy hút bụi cầm tay, Chống nghẹt ống bơm, Dung tích 480ml",Roborock,382200,Trung Quốc,"Máy bơm, máy cắt cỏ",450000,67800,15
230201962, Phao Lọc Cặn Bẩn Máy Giặt Thông Minh - Túi Lọc Gom Rác Lông Tóc Trong Lồng Máy Giặt - HÀNG CHÍNH HÃNG MINIIN,MINIIN,16000,Trung Quốc,Phụ kiện giặt ủi,19000,3000,16
276015652,1 Sạc pin đôi 18650 - Cục sạc pin 18650 - Sạc được 2 cục pin 18650 cùng lúc - Hàng chính hãng,Qualcomm,55000,Anh,Pin và dụng cụ sạc pin,69000,14000,20
117058329,Giấy lọc cà phê Hario 100 cái (V60-VCF-01-100W),Hario,94000,Nhật Bản,"Bình, ly uống cà phê và phụ kiện",99000,5000,5
275197186,Set 3 Hộp Tăm Chỉ Nha Khoa Làm Sạch Răng (150 cái/ 3 hộp),PEAFLO,32000,Thái Lan / Trung Quốc / Malaysia (Tùy từng đợt nhập hàng),Phụ kiện phòng ăn,45000,13000,29
274579225,"Ổ Cắm điện CYX A02 4 Cổng USB Sạc Nhanh, Đa Ổ Cắm, Dây Đồng Dài 3m, Công Suất 3000w",PEAFLO,235000,Hàn Quốc / Trung Quốc,,275000,40000,15
275382498,Bộ vắt cam chanh tiện dụng cỡ nhỏ Yoko - Giao màu ngẫu nhiên,Inochi,29000,Việt Nam,Phụ kiện nhà bếp,29000,0,0
43126026,"Bàn để ủi Inox 100x38cm (điều chỉnh được độ cao, không kênh chân)",Nguyễn Trường Thắng,680000,Việt Nam,Phụ kiện giặt ủi,680000,0,0
147964998,"Hộp Đựng Chia Thuốc 8 Ngăn Đi Du Lịch, Tiện Dụng, Nhỏ Gọn, Chắc Chắn, Ngăn Nắp, Nhựa An Toàn Môi Trường. TakyHome 7123",taky home,39000,Việt Nam,Phụ kiện phòng ngủ,39000,0,0
203054878,Nhiệt ẩm kế XIAOMI MIIIW S200 MWTH02 - Hàng Nhập Khẩu,Xiaomi,115640,HK/TQ,Thiết bị đo lường,118000,2360,2
274109371,Ga Trải Giường Lẻ Tencel Cao Cấp Ru9 - Chất Liệu 100% Tự Nhiên | Bao Gồm 6 Kích Thước | Nhiều Màu Sắc,Ru9,763000,Việt Nam,,1090000,327000,30
52587143,GIÁ TREO QUẦN ÁO GỖ LẮP RÁP HÀN QUỐC - SINGLE HANGER SIZE 1 MÉT - MÀU TỰ NHIÊN,MW Furniture,322050,Việt Nam,Phụ kiện giặt ủi,339000,16950,5
190706761,"Lồng bàn 5 tầng bảo quán đồ ăn, Lồng bàn đậy thức ăn giữ nhiệt - Chính hãng MINIIN ",MINIIN,116850,Trung Quốc,Phụ kiện nhà bếp,139000,22150,16
166408793,Giấy Lọc Kalita Wave,NOX COFFEE TAKE AWAY,140000,Japan,"Bình, ly uống cà phê và phụ kiện",140000,0,0
262914700,"Giàn phơi, giá gấp gọn phơi quần áo Inox chữ A cao cấp Sothing- Hàng chính hãng",SOTHING Xiangwu,319000,Trung Quốc,Phụ kiện giặt ủi,319000,0,0
275306781,"Máy xay tiêu, xay cà phê mini đa năng",Nhà của Mẹ,189050,China / Vietnam,Phụ kiện nhà bếp,199000,9950,5
275611449,"Thuốc trừ bệnh MANCOZEB Bột Xanh/Vàng, KLT: 100G",Vigami,24000,Việt Nam/ Ấn Độ,"Hoa tươi, Cây cảnh & Hạt giống",24000,0,0
10192902,Bộ 100 Ngón Tay Cao Su Milliken Tampe NL-3036,Milliken Tampe,17000,,Bảo hộ lao động,17000,0,0
274790298,Combo 12 miếng lót chân ghế hình vuông - Hàng chính hãng ,PaKaSa,25000,Trung Quốc,Bảo vệ nhà cửa,50000,25000,50
190755058,"Hạt Giống Hoa Sao Nhái Mix Greenhome, Gói 0,3gr, Sai Hoa, Màu Rực Rỡ, Dễ Trồng Quanh Năm, Nảy Mầm Cao H02",SENVANG SEEDS,11900,Việt Nam,"Hoa tươi, Cây cảnh & Hạt giống",20000,8100,41
3604695,Đèn Bắt Muỗi Điện Quang ĐQ EML04L,Điện Quang,450000,Việt Nam,,455000,5000,1
275354925,Nệm PE Hàn Quốc Cao Cấp Gấp 3 ( 1m4 x 1m95 x 3cm) Giao Màu Ngẫu Nhiên - Tặng Kèm Cặp Áo Gối,KINGROLL MATTRESS R,239000,Việt Nam,Nệm và phụ kiện,290000,51000,18
13392113,Đèn nháy năng lượng mặt trời 100 led - HT01-100,OEM,129000,,,129000,0,0
275428316,Xe Kéo Đi Chợ Đa Năng đa năng ,Anh Lam Store,315000,Trung Quốc / Singapore / Việt Nam,Phụ kiện nhà bếp,495000,180000,36
56658309,Hạt giống cải cầu vồng nhiều màu VTS77,Sen Vàng Seeds,12480,Ý,"Hoa tươi, Cây cảnh & Hạt giống",12480,0,0
113711175,Combo 2 set túi Zip đựng & bảo quản thực phẩm - nội địa Nhật Bản ( 16 chiếc size M + 12 chiếc size L),YAMADA,82100,Nhật Bản,Dụng cụ chứa đựng thực phẩm,82100,0,0
274954065,"Chăn cotton hình ca rô 200x230cm, chất liệu cotton mỏng nhẹ, mềm mịn với da, không bị phai màu- Hàng chính hãng",Nhà của Mẹ,275500,Việt Nam,"Chăn, mền và phụ kiện",290000,14500,5
66407202,"Cân Điện Tử 10kg/1g C18 ( CÂN NHÀ BẾP SIÊU MỎNG, ĐẸP, NHIỀU ĐƠN VỊ CÂN )",RuYishaogmao,289000,Trung Quốc,Dụng cụ làm bánh,299000,10000,3
273663760,"Dụng cụ xay tỏi ớt, thực phẩm Lebenlang LBL3939 lưỡi xay bén, dây rút tiện lợi - hàng chính hãng",Lebenlang,125000,Trung Quốc,Phụ kiện nhà bếp,199000,74000,37
271556348,"Móc Dán Tường, Móc Dính Tường Treo Đồ Nặng Siêu Dính Inox 304 - Treo Thớt, Nồi Niêu Xong Chảo, Treo Đồ Đa Năng",PEAFLO,45000,HK/TQ,,65000,20000,31
157023649,Cậy gạt rửa kính gương lưỡi cao su cán inox 304 Hobby Home Decor RK1,Hobby Home Decor,149000,Trung Quốc,Dụng cụ vệ sinh,199000,50000,25
192303236,Kìm bấm cúc áo kèm túi 100 cúc,OEM,35000,Trung Quốc,Dụng cụ sửa chữa nhà cửa,39000,4000,10
4581747,Phích Nước Nóng Rạng Đông 2035N3 899-2L,Rạng Đông,129000,Việt Nam,Bình/ Ly giữ nhiệt,129000,0,0
190755152,"Hạt Giống Cà Tím Trái Dài Greenhome, Gói 0,2gr, Dễ Trồng Quanh Năm, Nảy Mầm Cao, Thu Hoạch Nhanh, Năng Suất Cao T13",SENVANG SEEDS,11900,Việt Nam,"Hoa tươi, Cây cảnh & Hạt giống",17820,5920,33
94383157,Decal dán kính mờ sỏi đá sắc màu - Decal dán kính phòng khách - phòng ngủ - khách sạn - nhà hàng  - decal dan kinh Binbin DK53,Binbin,105000,Đài Loan,Decal & giấy dán kính,115000,10000,9
274301088,Khăn Lưới Cước Thép Vệ Sinh Chén Dĩa Xoong Chảo Đa Năng,NAVIVU,15000,Trung Quốc,Phụ kiện nhà bếp,15000,0,0
918140,Keo Dán Đa Năng Dog HTN Tool X-66 (100ml)  ,HTN Tool,43000,Việt Nam,Dụng cụ sửa chữa nhà cửa,44000,1000,2
185859044,"Tranh 3D Koifish, Tranh Dán Bể Cá,Đá dưới biển , in tranh theo kích thước yêu cầu",AQuarium BACKGROUNDS 3D ,59000,Việt Nam,Decal & giấy dán kính,59000,0,0
213558340,"Cờ lê vặn vòi nước đa chức năng tiện dụng, cờ lê hở, cờ lê vặn dây cấp nước",OEM,49999,Việt Nam,Dụng cụ sửa chữa nhà cửa,49999,0,0
208412106,Lót ly vuông khảm trai ECOHUB bộ 6 miếng,ECOHUB,209000,Việt Nam,"Ly, cốc & phụ kiện ly",220000,11000,5
273829039,"Combo 5 Móc Treo Quần Áo Chống Trượt, Biến Dạng Quần Áo, Móc Áo Nhựa Cao Cấp Chịu Tải Lớn Xoay 360 - Chính Hãng",PaKaSa,59000,Trung Quốc,Phụ kiện giặt ủi,118000,59000,50
270142255,"GỐI TRÀO NGƯỢC DẠ DÀY NGƯỜI LỚN YOROKOBI, KÍCH THƯỚC 70*60*18CM (Bo tròn chống trượt), HỖ TRỢ TRÀO NGƯỢC ACID, Ợ CHUA, THOÁI HÓA CỘT SỐNG CỔ, HÀNG THƯƠNG HIỆU",Yorokobi,769000,Việt Nam,"Gối, ruột gối, vỏ gối",850000,81000,10
3905109,Gậy Gắp Rác Inox Prota - PT-965,Prota,85000,Việt Nam,Phụ kiện nhà tắm,85000,0,0
175567366,Đèn Pin Cầm Tay Siêu Sáng P50 Có Đèn Báo Dung Lượng Pin Mẫu Mới Tặng Kèm Pin 16850 Và Cáp Sạc FULLBOX - Chính Hãng,PaKaSa,261800,Trung Quốc,,346000,84200,24
274993778,"{Nhiều Lựa Chọn} Móc Treo Quần Áo, Móc Treo Đa Năng Hara, Bộ Sưu Tập Móc Quần Áo Người Lớn Nhựa Cao Cấp Inochi",Inochi,59000,Việt Nam,Phụ kiện giặt ủi,76000,17000,22
102740952,Hộp 40 viên Pin than tiểu đen AA Panasonic R6NT/4SB-V – Hàng Chính Hãng,Panasonic,176000,Nhật Bản,Pin và dụng cụ sạc pin,192000,16000,8
203085160,Hộp két sắt chữ nhật đựng tiền mặt và đồ vật nhỏ có giá trị - Hộp tiết kiệm tiện lợi - Loại khóa chìa - Màu be - Size S,TRENY,242000,Trung Quốc,Bảo vệ nhà cửa,242000,0,0
252600542,"Đĩa lót chậu nhựa trồng cây Monrovia chậu trồng cây, chậu cây cảnh mini, để bàn, treo ban công, treo tường, chính hãng",Monrovia,15000,Trung Quốc,"Hoa tươi, Cây cảnh & Hạt giống",15000,0,0
275224241,"Bộ 3 mũi khoan bước, tháp phủ titanium 3-12Mm 4-12Mm 4-20Mm khoét lỗ tròn chuyên khoan sắt, gỗ, tôn nhôm",ratoff-ars,85000,China,Các loại máy và phụ kiện,85000,0,0
274946754,"100 thìa muỗng/ nĩa/ dao gỗ xuất khẩu Nhật dùng 1 lần dài 16cm/ 11cm dùng ăn kem, bánh kem, cafe, salad",BIOGREEN,41040,Việt Nam,"Đũa, muỗng, nĩa",41040,0,0
49047400,Ghế quầy bar gấp hòa phát,Hòa Phát,383000,Việt Nam,Nội thất phòng ăn,383000,0,0
111411475,Nút tai chống ồn 3M 1290 - Bịt tai chống ồn lên đến 29Db,3M,25000,Mỹ,Bảo hộ lao động,25000,0,0
68265957,Kéo chuyên dụng cắt tỉa cây cảnh Echo  - Nội địa Nhật,Echo,40500,Nhật Bản,Dụng cụ làm vườn,40500,0,0
275283146,"Máy bơm hơi bằng điện bơm bóng, bơm bể bơi công suất cao ",Nhà của Mẹ,142500,China / Vietnam,Các loại máy và phụ kiện,150000,7500,5
169362095,"Bàn Chải Chà Chân , Chà Sàn , Giặt Đồ Có Khay Đựng Xà Phòng Hiện Đại GroFa - Chính Hãng",Gro-Fa,39000,Trung Quốc,Dụng cụ vệ sinh,39000,0,0
275890887,1kg túi rác đen công nghiệp size 90x120,EIG,40000,Việt Nam,Dụng cụ vệ sinh,40000,0,0
181000618,Bản Lề Đóng Cửa Tự Động Mẫu Mới KUNBE Phù Hợp Cửa Vừa Và Nhẹ Dễ Đóng Mở Không Gây Hư Hỏng Cửa,KUNBE,142000,Trung Quốc,Bảo vệ nhà cửa,142000,0,0
273476082,"Nắp Đậy Cống Thoát Sàn GonQin Đệm Silicone - Chống Côn Trùng,Chống Muỗi Thiết Kế Hoa Anh Đào",GonQin,57000,Trung Quốc,Thiết bị phòng tắm,75000,18000,24
4426075,Dụng Cụ Gắp Đồ Nóng Thức Ăn,OEM,20000,Việt Nam,Phụ kiện nhà bếp,39000,19000,49
78972573,Vòi tắm lạnh 2 đường nước đầu vòi đa năng yamato CSIPro (Hàng chính hãng),YAMATO,176000,Việt Nam,Thiết bị phòng tắm,250000,74000,30
105515134,"Bộ 04 chân kê máy giặt chống rung, chống ồn, chống xê dịch giúp tăng tuổi thọ máy giặt",OEM,69000,Việt Nam,Phụ kiện giặt ủi,69000,0,0
275732749,"Két sắt mini có khe đút tiền chống trộm bảo mật cao, nhỏ gọn, chống cháy, có ốc vít vào tường- màu giao ngẫu nhiên",Nhà của Mẹ,408500,China / Vietnam,Nội thất phòng ngủ,430000,21500,5
203767246,"Áo Mưa Cánh Dơi PC Vải BEST Cao Cấp, GIÁ SỈ, RANDO Chính Hãng, Vải Dù Bền Bỉ Không Thấm Nước, Xẻ Tà Cho Nam Nữ",Rando,329000,Việt Nam,,329000,0,0
269944670,Miếng Rửa Chén Xơ Mướp Vi Lâm Chuyên Gia Rửa Sạch Bát Đĩa Xoong Nồi - Không Hại Da Tay - Thân Thiện Môi Trường,Xơ mướp Vi Lâm,19000,Việt Nam,Phụ kiện nhà bếp,19000,0,0
82384677,"Đế chống rung máy giặt, chân máy giặt chân bàn 4 miếng cao su cao cấp, chống rung chống ồn chống trơn trượt (Giao màu ngẫu nhiên)",OEM,19000,Việt Nam,Phụ kiện giặt ủi,19000,0,0
50730955,Combo 3 cái Đầu vòi tăng áp 3 mức độ cho bồn rửa chén,OEM,97020,Trung Quốc,Phụ kiện nhà bếp,99000,1980,2
275025624,Miếng pás ốp dùng cho đèn đường năng lượng mặt trời Vạn Năng Solar,Vạn Năng Solar,99000,Trung Quốc,Bóng và linh kiện đèn,99000,0,0
6077831,Ổ Khoá Việt Tiệp Loại Nhỏ 57 x 36 Ống Phi 6mm (Khoá Chìa),Việt Tiệp,70200,Việt Nam,Bảo vệ nhà cửa,70200,0,0
74257086,Hạt giống rau mầm củ cải đỏ Italy gói 100g VTS120,Sen Vàng Seeds,22880,Ý,"Hoa tươi, Cây cảnh & Hạt giống",22880,0,0
124690968,[HOT] - Bộ 3 lõi lọc thô 123 chính hãng Karofi dùng cho máy lọc nước RO,Karofi,134000,Việt Nam,"Bình lọc, lõi lọc, thiết bị lọc nước",134000,0,0
273938207,"Nhang Nụ Quế Chi 100g - MỘC LÂM, Nhang Nụ Khói Ngược Cao Cấp Xông Nhà Thanh Tẩy",mộc lâm,112330,Việt Nam,,145000,32670,23
178768037,"KÉO GIA DỤNG 8'', 200mm TOLSEN 30044 - HÀNG CHÍNH HÃNG",Tolsen,55370,China,"Dao, kéo và phụ kiện",55370,0,0
19351701,Bộ 2 gói gồm 200 túi lọc rác bồn rửa thông minh có thể tái sử dụng,OEM,59850,,Phụ kiện nhà bếp,63000,3150,5
124480954,"Nhang trầm hương tự nhiên Thiên Mộc Hương, 20cm, Ít Khói, Mùi thơm nhẹ diu, an toàn cho sức khỏe",Thiên Mộc Hương,150000,Việt Nam,,200000,50000,25
161253442,Kìm Đa Năng 6-8 inch Deli Cao Cấp Chính Hãng - Chất Liệu Thép Cacbon Siêu Bền - Có Thể Sử Dụng Nhiều Mục Đích,Deli,69000,Trung Quốc,Dụng cụ sửa chữa nhà cửa,124200,55200,44
54150625,"Combo 9 cuộn Túi đựng rác văn phòng, Bao đựng rác trường học tiện lợi 3 màu size trung 55x65",Túi ni lông tự phân hủy sinh học GIMEX II,80000,,Dụng cụ vệ sinh,80000,0,0
190613922,GẠT TÀN HỔ 2022 | GẠT TÀN THUỐC HÌNH HỔ HỢP KIM ĐỒNG | Gạt tàn con Hổ hoạ tiết hoa văn cổ hợp kim cao cấp,CRYSTAN,199900,Việt Nam,Phụ kiện phòng ăn,199900,0,0
272361875,Nồi áp suất Nagakawa NAG1441 - Hàng chính hãng,Nagakawa,405000,,Nồi và chảo,495000,90000,18
275342434,Hạt giống Củ cải xanh  - củ Cải đường cao sản củ to giòn ngọt VTP67,An Phát ,19760,Việt Nam,"Hoa tươi, Cây cảnh & Hạt giống",19760,0,0
275773185,Bong Bóng Dài Siêu Nhũ Bóng Giun Siêu Nhũ Chrome Dài Chuyên Tạo Hình Nghệ Thuật Bóng Vặn Tạo Hình,Diệp Linh,30000,Việt Nam,Trang trí nhà cửa khác,30000,0,0
4629707,"Bộ 2 Hộp HCN Chia Ngăn (670ml, 400ml) Và Túi Giữ Nhiệt Glasslock Lunch Set 02-2",GlassLock,250000,Hàn Quốc,Bộ hộp cơm và phụ kiện,369000,119000,32
191356959,Dù Chống Tia UV MINI Siêu Gọn 8 Xương Có Hộp Đựng Chống Sốc,NAVIVU,150000,Thái Lan / Trung Quốc / Malaysia (Tùy từng đợt nhập hàng),"Áo mưa, ô dù và phụ kiện đi mưa",150000,0,0
189701066,"Bộ 2 chân đế chữ L hỗ trợ mặt bàn, ke chữ L dày 1cm treo tường bằng thép đặc phủ sơn tĩnh điện",BATODA,320000,Việt Nam,"Nội thất phòng học, làm việc",320000,0,0
103755910,"Ghế tatami, ghế lười bệt tựa lưng nệm - Có 5 cấp độ ngã lưng - Chính hãng TIDO",TIDO,331500,Việt Nam,Nội thất phòng khách,390000,58500,15
274144270,(Bền Bỉ) Dây Vòi Xịt Toilet - Vòi Sen Tắm KhoNCC Hàng Chính Hãng - Bằng Inox Dài 1m5 - Sử Dụng Linh Hoạt Tiện Lợi - KLM-DVSVXTL,KHONCC,49000,China,Thiết bị phòng tắm,63000,14000,22
272129309,Khăn tắm cotton | JYSK Ysby | nhiều màu | nhiều kích thước,JYSK,43120,Ấn Độ,Khăn,49000,5880,12
185821390,Combo 3 Tấm Lót Cách Nhiệt Ủi Đồ Bảo Vệ Quần Áo - Hàng Chính Hãng ( Giao màu ngẫu nhiên),PaKaSa,39000,Trung Quốc,Phụ kiện giặt ủi,78000,39000,50
273714788,"Thanh Dán Silicon Chặn Nước Tràn Cho Phòng Tắm, Nhà Vệ Sinh",NAVIVU,85500,Trung Quốc,Phụ kiện nhà tắm,85500,0,0
73758944,Kệ Đa Năng Để Lò Vi Sóng INOX Trắng Cao Cấp Chống Han Gỉ Kệ Để Đồ Nặng Siêu Gọn Cho Nhà Bếp VANDO,VANDO,299000,Việt Nam,,299000,0,0
273607042,Nồi Inox 3 Đáy Sunhouse SHG301 ( Dùng cho mọi loại bếp),Sunhouse,193000,Việt Nam,Nồi và chảo,250000,57000,23
213598604,Máy khoan từ sử dụng động cơ không chổi than,MKT,599000,Nhật Bản / Trung Quốc,Các loại máy và phụ kiện,599000,0,0
131407865,bàn làm việc chân gấp gọn,HG FURNITURE H i G,450000,Việt Nam,"Nội thất phòng học, làm việc",450000,0,0
273384614,Đèn năng lượng mặt trời chóng lóa Vạn Năng Solar 100W,Vạn Năng Solar,659000,Trung Quốc,Đèn ngoài trời,690000,31000,4
148654134,"Áo bọc bàn để ủi quần áo nhiều size, nhiều mẫu - CHỌN SIZE - Áo trùm bàn ủi đồ, giao mẫu ngẫu nhiên tùy đợt hàng",SOHOGO,99000,Việt Nam,Phụ kiện giặt ủi,99000,0,0
184860535,"Bàn làm việc,bàn học chân sắt sơn tĩnh điện UN (full phụ kiện lắp ráp dễ)",Ánh Dương,199000,Việt Nam,"Nội thất phòng học, làm việc",199000,0,0
273298575,"Đèn Bàn Học Chống Cận, Khử Ánh Sáng Xanh Tamayoko TB-20. Ánh Sáng Ổn Định Không Nhấp Nháy 3 Chế Độ Ánh Sáng Bảo Vệ Mắt",Tamayoko,844000,Trung Quốc,Đèn học và đọc sách,879000,35000,4
789378,Hũ Thủy Tinh Tay Cầm Kova HTC-0.85 (850ml),KOVA,24000,Hàn Quốc,Dụng cụ chứa đựng thực phẩm,79000,55000,70
155184630,"Móc Treo Quần Áo, Móc Treo Đa Năng Hara, Bộ Sưu Tập Móc Quần Áo Người Lớn Nhựa Cao Cấp Inochi",Inochi,26950,Việt Nam,Phụ kiện giặt ủi,26950,0,0
274625547,Sữa hạt xương khớp Ovisure Gold Lon 650g chính hãng date mới- Tốt cho xương khớp,IcoPhar,790000,Việt Nam,,795000,5000,1
131184578,Đồng Hồ Treo Tường Tròn Chạy Êm Không Tiếng Động Deli - Thiết Kế Decor Trang Trí Nhà Và Quán Cafe,Deli,309000,Trung Quốc,Đồng hồ,556200,247200,44
63051068,"Bình xịt chống thấm đa năng chai xịt ngăn dột nước trần sàn mái tôn, chân tường nhà (màu trắng)",OEM,27000,Trung Quốc,"Sơn, dầu mỡ, hóa chất",31111,4111,13
62875748,Áo Mưa Rando Easy Trum APPC-10 - Màu Ngẫu Nhiên,Rando,80000,Việt Nam,"Áo mưa, ô dù và phụ kiện đi mưa",80000,0,0
273687569,Nồi Áp Suất FUJIKA Đáy Từ Hợp Kim Cao Cấp An Toàn Nấu Được Trên Mọi Loại Bếp-Hàng Chính Hãng,FUJIKA,375000,Trung Quốc,Nồi và chảo,375000,0,0
176466229,Kìm Tuốt Dây Điện Bấm Cos Đa Năng Deli Chất Liệu Thép Cao Cấp Điều Chỉnh Lực Tuốt Dây Dễ Dàng DL2018,Deli,214000,Trung Quốc,Dụng cụ sửa chữa nhà cửa,385200,171200,44
68459703,"10 ống thép bọc nhựa phi 8 của nhật có nhiều kích thước lựa chọn dùng bền trên 5 năm chuyên dùng làm khung giàn cho cây leo, cắm chống đỡ cây trồng",DAIM,94500,Nhật Bản / Việt Nam,,94500,0,0
127693039,"1Kg, 5Kg, 10Kg, 18Kg Keo Sơn Chống Thấm Sàn Mái Lộ Thiên TAIKO NITTON (Gốc Acrylic) - Tặng Kèm Vải Kết Cấu Và Chổi Lăn Sơn - Chống Thấm Sàn Mái, Máng Xối, Ban Công Lô Gia, Bể Nước, Bể Cá, Bề Mặt Cát Xi Măng (Hiệu quả hơn khi pha với Xi Măng",TAIKOMI,224000,Nhật Bản / Việt Nam,"Sơn, dầu mỡ, hóa chất",320000,96000,30
205223299,Hộp cơm giữ nhiệt văn phòng Inox 304 Emich EL8293 dung tích 1.8 Lít,Elmich,736000,Trung Quốc,Bộ hộp cơm và phụ kiện,1190000,454000,38
242226198,"Bình Lắc Shaker Nhựa dụng cụ pha chế chuyên nghiệp, 350ml, 500ml, 700ml, 1000ml, giao hàng nhanh",CRYSTAN,63000,Việt Nam,,63000,0,0
205579377,Đèn học để bàn chống cận tích điện Weidasi 6079 - LED 3 mức độ sáng bảo vệ mắt đọc sách làm việc - Thân mềm xoay linh hoạt,WEIDASI,270000,China,Đèn học và đọc sách,320000,50000,16
239979816,Vỏ Gối Nằm Chần Bông Cotton K-bedding by Everon 45x65cm ( 1 cặp),K-Bedding,317000,Việt Nam,"Gối, ruột gối, vỏ gối",460000,143000,31
275057618,Combo 3 đèn 8 led siêu sáng cắm USB - Hàng chính hãng ,Gro-Fa,49000,Trung Quốc,,49000,0,0
274050649,"Ô tự động thông minh hai chiều Nason Umbrella phiên bản V3 chống gió cấp 6, ô gấp ngược, tối ưu hóa khả năng chắn nước",Nason Umbrella,265050,Việt Nam,,400000,134950,34
275340745,"Kệ Sách Gỗ Để Bàn Mini FB28 FIVO Dễ Lắp Ráp, Tiết Kiệm Diện Tích, Decor Trang Trí Bàn Học Và Bàn Làm Việc",FIVO,275000,Việt Nam,"Nội thất phòng học, làm việc",295000,20000,7
191221410,"Sen cây tắm đứng nóng lạnh inox 304 KOSKO (BH 24 THÁNG), sen tắm nóng lạnh tròn L",KOSKO,857000,Việt Nam,Thiết bị phòng tắm,1500000,643000,43
204610431,Ổ Cắm Đơn Wifi Rạng Đông,Rạng Đông,185000,Việt Nam,"Ổ cắm, ổn áp, biến áp",185000,0,0
274848186,"Vỏ Áo Bọc Nệm Thun Lạnh Khóa Kéo 2 Đầu, Áo Nệm Topper, Gấp 3 Cariva Đủ Kích Thước",Cariva,160000,Việt Nam,Nệm và phụ kiện,160000,0,0
181988661,Bình Bơm ga cho bật-lửa-hộp-quẹt kèm 5 đầu bơm các loại bật-lửa-gas - Blue Hàn Quốc 150 gram,OEM,69000,Hàn Quốc,"Bếp nướng, vỉ nướng",69000,0,0
113125339,"Chuông cửa không dây thông minh CTFAST CAZI - 01, chống nước, khoảng cách sử dụng hiệu quả 300 mét, 36 bài nhạc chuông - hàng chính hãng",CTFAST,155000,Trung Quốc,Bảo vệ nhà cửa,179000,24000,13
198850117,"Bộ Hộp Cơm Giữ Nhiệt Lock&Lock Dung Tích  1.150ml (450ml*1, 420ml*1, 280ml*1  Kèm Đũa Và Túi Xách) Giữ Nhiệt Tới 6h - Màu Xám",LocknLock,755000,Trung Quốc,Bộ hộp cơm và phụ kiện,1398000,643000,46
214613983,"Két Sắt Mini Khóa Điện Tử Chống Cháy, Có Độ Bảo Mật Cao - Két sắt an toàn cho mọi gia đình có khe đút tiền",SEKA,319000,Hong Kong,Nội thất phòng ngủ,319000,0,0
150563551,1 Gối Lông Vũ Microfiber Sài Gòn 47x67cm - tặng kèm túi xách sang trọng,A,180000,Việt Nam,"Gối, ruột gối, vỏ gối",308000,128000,42
60178807,"Hộp 100 viên nến tealight cháy 2h không mùi, không khói ",Aroma,85000,Việt Nam,Trang trí nhà cửa khác,85000,0,0
149387829,"Hộp Đựng Giấy Vệ Sinh Đa Năng 2 Tầng Treo Tường Cao Cấp - Có Ngăn Kéo Và Khe Cắm Điện Thoại, Ipad - Hàng Chính Hãng Nhập Khẩu",MINIIN,118750,Trung Quốc,,129000,10250,8
6695249,"Kéo cắt tỉa cành cây 8"" total THT0109",Total,84000,Trung Quốc,Dụng cụ làm vườn,84000,0,0
68078093,2 Cuộn Túi Hút Chân Không Thực Phẩm Một Mặt Nhám Một Mặt Trơn Dạng Hạt Mịn Hàng Chính Hãng,Shineye,85000,Trung Quốc,Dụng cụ chứa đựng thực phẩm,85000,0,0
270057705,"Cân tiểu ly điện tử mini nhà bếp, cà phê DandiHome có độ chính xác cao",DandiHome,95000,Trung Quốc,Dụng cụ làm bánh,110000,15000,14
150805933,Túi 50 miếng lót lót bồn cầu dùng 1 lần nơi công cộng,Song An Eco,55000,Việt Nam,Phụ kiện nhà tắm,55000,0,0
161022775,"Thước cuộn tự động Tolsen 36016 hợp kim thép cao cấp, dây dài 8m, vỏ nhựa PVC cứng cáp - Hoa Sen Home - Hàng chính hãng",Tolsen,200000,Việt Nam,Thiết bị đo lường,200000,0,0
206818642,GHẾ BỐ XẾP THƯ GIÃN GIÁ RẺ CADATI,HAKAWA,1057000,Trung Quốc,Nội thất phòng khách,1090000,33000,3
111410485,Găng tay lao động chống cắt 3M Cấp độ 1 - Găng tay bảo hộ chống đâm xuyên tiêu chuẩn EN388:4131 - Sản phẩm chính hãng,3M,32000,Việt Nam,Bảo hộ lao động,32000,0,0
275627108,[KV] Ly giấy 10oz~295ml - Lốc 50 ly giấy trơn,New Star Paper,31000,Việt Nam,"Ly, cốc & phụ kiện ly",31000,0,0
273135436,Máy Khoan Pin Mini Bắt Vít Đa Năng Gia Dụng Thông Minh Pin 1800 mAH Kèm Hộp Nhựa giao hàng nhanh,OLAX,224000,HK/TQ,Các loại máy và phụ kiện,229000,5000,2
89979556,"Chặn Cửa Bán Nguyệt, Chặn Cửa Gắn Sàn, Chống Va Đập Tay Nắm Cửa Với Tường",TakyHome,31900,Việt Nam,Bảo vệ nhà cửa,31900,0,0
216213220,"Băng Keo Cao Su PVC Vá Ống Nước, Vá Thau Chậu, Đệm Hơi Tức Thì",NAVIVU,39000,Trung Quốc,Dụng cụ sửa chữa nhà cửa,39000,0,0
117789474,Giá thể ( Đất sạch trộn sẵn) trồng cây tổng hợp 70 L-Jardino universal,Jardino,450000,Hà Lan,"Hoa tươi, Cây cảnh & Hạt giống",450000,0,0
106699435,"Bàn làm việc, bàn học ngồi bệt gaming - Chân gấp gọn - Lắp sẵn - Chính Hãng TIDO",TIDO,381650,Việt Nam,"Nội thất phòng học, làm việc",449000,67350,15
252600988,"Chậu nhựa trồng cây MONROVIA để bàn, treo ban công, treo tường, ngoài trời, sân vườn, tiêu chuẩn Châu Âu",Monrovia,28000,Trung Quốc,"Hoa tươi, Cây cảnh & Hạt giống",28000,0,0
273384714,Đèn pha năng lượng mặt trời Vạn Năng Solar 60W,Vạn Năng Solar,548000,Trung Quốc,Đèn ngoài trời,548000,0,0
117160060,Kệ 5 tầng tấm lưới ngang 122cm CSPS,CSPS,2499000,Việt Nam,Nội thất phòng khách,2499000,0,0
249253408,"Bộ nồi 5 đáy Inox 304 Elmich Berlin EL 3980 Size 16, 18, 22cm",Elmich,1116000,Việt Nam,Nồi và chảo,1685000,569000,34
214937337,"Máy rửa xe áp lực cao SUMIKA S8, công suất 1600W, 100% lõi đồng, chế độ Auto Stop",Sumika,1160000,Trung Quốc,Máy xịt rửa và phụ kiện,1800000,640000,36
74695680,"Hộp đựng cơm văn phòng, Hộp Cơm Cắm Điện 3 Tầng Inox ,Hộp hâm nóng thức ăn YOICE- HÀNG CHÍNH HÃNG",Yoice,479000,Trung Quốc,Dụng cụ chứa đựng thực phẩm,479000,0,0
66115276,"Biến áp xuyến cách ly TODAL- 2KVA ngõ ra 220v, 120v, 100v dây đồng",TODAL,2100000,Việt Nam,"Ổ cắm, ổn áp, biến áp",2100000,0,0
118013165,Đựng Đũa Muỗng Inox 304 3 Ngăn  Có Khay Hứng Nước -  Kèm Móc Treo Đồ Đa Năng,SenNai Furnitures,89000,Việt Nam / Trung Quốc,,89000,0,0
42333530,Mền Lông cừu cao cấp Ánh Sao - kích thước lớn - 1m8 x 2m,A,220000,Việt Nam,"Chăn, mền và phụ kiện",220000,0,0
274843590,GHẾ BỐ XẾP THƯ GIÃN GIÁ RẺ CADATI C-03 - KHÔNG NỆM,HAKAWA,1290000,Trung Quốc,Nội thất phòng khách,1290000,0,0
205985398,Ghế công thái học Nghia furniture LUMBAR - Ghế xoay văn phòng làm việc nhiều tính năng khủng,Nghia Furniture Best choice for nicehome,2960000,Trung Quốc,"Nội thất phòng học, làm việc",3900000,940000,24
235734839,MÁY CƯA XÍCH DÙNG PIN 21V DEKTON M21-CS06BLC - HÀNG CHÍNH HÃNG,Dekton,865172,China,Các loại máy và phụ kiện,865172,0,0
275275000,Keo Đất Sét Xi Măng Dẻo Bịt Tường 160gr Vá Trám Lỗ Điều Hoà Chống Thấm Cách Nhiệt Sửa Chữa Nhà Cửa Hamart,LKB,29000,Trung Quốc,Dụng cụ sửa chữa nhà cửa,49000,20000,41
164433381,Bộ Đèn PHILIPS LED Âm Trần MESON IO Thế Hệ Mới - 5W 7W 9W 13W,Philips,100900,Trung Quốc,Đèn trần,154000,53100,34
275174743,Đệm ngủ trưa văn phòng gấp gọn EMA loại cao cấp dày 1cm - tặng kèm túi đựng,Ema,179000,Trung Quốc,Phụ kiện phòng ngủ,358000,179000,50
177924150,"Nệm cao su non Thắng Lợi,  đệm cao su tổng hợp hàng chính hãng bảo hành 15 năm",Nệm Thắng Lợi,1000000,Việt Nam,Nệm và phụ kiện,1000000,0,0
274656896,Tủ giày thông minh 3 cánh lật tiết kiệm diện tích gỗ mdf phủ melamin chống xước thương hiệu IGA - Gp20,IGA,950000,Việt Nam,Nội thất phòng khách,950000,0,0
99338532,LƯỚI VÕNG DUY LỢI MỀM MỊN NẰM ÊM,Duy Lợi,429000,Việt Nam,Phụ kiện phòng ngủ,429000,0,0
213524622,Máy Khoan SUSANO Đầu Khoan 10mm và 13mm Có Chế Độ Búa Công Suất 1350W - Có Điều Chỉnh Tốc Độ - Motor 100% Dây Đồng,SASUNO,299000,Nhật Bản / Trung Quốc,Các loại máy và phụ kiện,299000,0,0
696521,Ổ Cắm Điện 4 Lỗ 3 Chấu 2 cổng USB Philips SPN6248WB/74 (2500W),Philips,391000,Trung Quốc,"Ổ cắm, ổn áp, biến áp",469000,78000,17
271099916,Kèn Melodion Melodica 32 Phím Giá Rẻ Đủ Màu Cho Bạn Mới Tập Chơi,Woim,236550,Việt Nam,Nhạc cụ hơi,249000,12450,5
271336834,Thớt gỗ tràm LocknLock CKD076 - Độ dày 35mm - Màu gỗ tự nhiên -CN-6,LocknLock,376000,Trung Quốc,Phụ kiện nhà bếp,749000,373000,50
169919224,"Kệ Để Kem Đánh Răng & Bàn Chải, Tặng Kèm Cốc - Kệ Nhà Tắm Dán Tường Thông Minh - Giá Treo Bàn Chải Đánh Răng Kiêm Để Đồ & Úp Cốc - Giao Màu Ngẫu Nhiên [HÀNG CHÍNH HÃNG",ENCOVINA,99000,Trung Quốc,,120000,21000,18
161228084,Kệ Để Đồ Biến Hình 3 Tầng Xoay Ngang VANDO Kệ Đa Năng Nhà Bếp Xe Đẩy Giỏ Tháo Rời Thông Minh,VANDO,949000,China / Vietnam,,1510000,561000,37
185492139,kệ lồng chim 5 tầng,ADORA,2550000,Việt Nam,Nội thất phòng khách,2550000,0,0
213491032,Bàn để ủi quần áo khung bằng thép Lebenlang LBB363,Lebenlang,629000,Trung Quốc,Phụ kiện giặt ủi,959000,330000,34
58855241,Nắp nhựa bồn cầu HA02 (nắp rơi tự do),Hùng Anh,190000,Việt Nam,Thiết bị phòng tắm,190000,0,0
205817287,"Dây Đèn Led Trang Trí Dùng Pin - Bóng Tròn Chớp Trang Trí Noel, Lễ, Tết",Luxury Store,45000,Việt Nam,,45000,0,0
275247448,"Đệm Trải Sàn, Nệm, Topper Hàng Xuất Nhật Đủ Size Tặng Kèm Drap Nệm",FUKOJI,399000,Việt Nam,Nệm và phụ kiện,500000,101000,20
81964016,BỘ VÕNG XẾP DUY LỢI THÉP SƠN CỠ LỚN,Duy Lợi,1288000,Việt Nam,Phụ kiện phòng ngủ,1288000,0,0
190702462,"Đế Kê Chậu Cây Greenhome, R21xc10cm, Bằng Sắt Sơn Tĩnh Điện, Màu Đen, Uốn Mỹ Nghệ, Bền, Đẹp, Nhiều Hình Dạng Lựa Chọn",Greenhome,38900,Việt Nam,"Hoa tươi, Cây cảnh & Hạt giống",62820,23920,38
129183017,Nệm tiện ích Everon Lite ( mẫu ngẫu nhiên ),Everon,355500,Việt Nam,Nệm và phụ kiện,395000,39500,10
68736740,Ruột gối nằm lông vũ khách sạn cao cấp sợi microfiber nhân tạo Hanvico by Homemark có kích thước trẻ em và 50x70 cm,Hanvico,126000,Việt Nam,"Gối, ruột gối, vỏ gối",250000,124000,50
68716607,Dao Thái Sunhouse KS-KN165SS,Sunhouse,64000,Việt Nam,"Dao, kéo và phụ kiện",117000,53000,45
274607973,Đèn Pin Siêu Sáng XML-T6 PaKaSa - Hàng Chính Hãng,PaKaSa,121380,Trung Quốc,,186000,64620,35
272250918,"Nắp Bịt Cống Chống Côn Trùng Hiệu Quả, Nắp Cống Ngăn Mùi Hôi",DORON the best service,45000,Trung Quốc,Thiết bị phòng tắm,45000,0,0
196567855,Rèm Cửa Sổ Phòng Ngủ - Khả Năng Chống Nắng Tốt - Vải Trang Trí Decor - DIGA HOME,MODERO,58000,Việt Nam,Nội thất phòng khách,68000,10000,15
68273951,Sofa bệt biến hình POANG-sofa tùy chỉnh hình dáng linh hoạt,POANG,2950000,Việt Nam,Nội thất phòng khách,2950000,0,0
103949833,Máy Phát Điện Chạy Xăng 3.5KW AmaxGold AMG3900- Hàng chính hãng,Amaxgold,9540000,Trung Quốc,Các loại máy và phụ kiện,9540000,0,0
273662531,(5 Đôi) Đũa Trắc Tự Nhiên Siêu Sạch Cẩn Xà Cừ - Hoa Văn Sáng Đẹp [CTL704-5],HAHANCO,170000,Việt Nam,"Đũa, muỗng, nĩa",170000,0,0
211924790,"Kệ Để Đồ Nhà Tắm - Kệ Gắn Tường Nhà Bếp, Phòng Tắm Chất Liệu Nhôm Cao Cấp",ENCOVINA,98000,Trung Quốc,,150000,52000,35
242806238,"Cốc Khuấy Tự Động Pha Cafe, Sữa, Cốc Khuấy Tự Động 380ml Dùng Pin Lõi Inox 304 Không Rỉ Giữ Nhiệt Tốt - HÀNG CHÍNH HÃNG MINIIN",MINIIN,93000,Trung Quốc,Bình/ Ly giữ nhiệt,119000,26000,22
176727759,Thùng Rác Đạp Chân Mẫu Tròn Nhiều Cỡ Hiro Hàng Xuất Nhật - Chính Hãng ( Tặng kèm khăn lau pakasa) Giao màu ngẫu nhiên,Inochi,176000,Việt Nam,Dụng cụ vệ sinh,201000,25000,12
53258075,Kệ Sách Treo Tường Chữ Nhật Kết Cấu Giấu Chân Chắc Chắn SIB DECOR,SIB DECOR,575000,Việt Nam,"Nội thất phòng học, làm việc",850000,275000,32
248418565,Ổ Cắm Điện Đa Năng Kèm Cổng USB Có Công Tắc Chống Giật Chống Cháy Chất Lượng Cao Deli - Hàng Chính Hãng - ET407 408,Deli,175000,Trung Quốc,"Ổ cắm, ổn áp, biến áp",315000,140000,44
275338165,Móc Dán Tường Có Đinh Ốc Vít Miếng Dán Tường Đóng Đinh Tiện Lợi Ko Khoan Đục Tường,GUANG MING,8000,Trung Quốc,,13000,5000,38
275213409,Bình giữ nhiệt inox 304 Elmich EL-8334 dung tích 400ml - Hàng Chính Hãng,Elmich,257450,Trung Quốc,Bình/ Ly giữ nhiệt,450000,192550,43
51737688,Túi Đựng Chăn Màn - Hộp Đựng Quần Áo Khung Sắt Gấp Gọn Amalife - Màu Ngẫu Nhiên,Amalife,80360,Trung Quốc,Phụ kiện phòng ngủ,82000,1640,2
54389885,"Ấm đun nước 1 lít, bằng Inox, chính hãng Zebra (Prima - 113431)",Zebra,512000,Thái Lan,,512000,0,0
74008888,Đui đèn cảm biến chuyển động - ánh sáng Rạng Đông,Rạng Đông,145950,Việt Nam,Bóng và linh kiện đèn,145950,0,0
134648801,[Kèm ảnh thật - Miễn phí lắp đặt & vận chuyển] Giường ngủ gỗ công nghiệp cao cấp OHAHA chuẩn Nhật - Yellow - GC041 - 01, OHAHA.VN,3200030,Nhật Bản / Việt Nam,Nội thất phòng ngủ,3299000,98970,3
272000489,"Lồng Đèn Sứa Biển, Lồng Đèn Bạch Tuộc, Đèn Lồng Trung Thu Tua Rua Hottrend Trang Trí Phòng Ngủ- Hàng loại 1 - Chính Hãng MINIIN",MINIIN,29000,Trung Quốc,,39000,10000,26
69247964,"GIÀN CHO HOA LEO KÍCH THƯỚC 1.8*2.1M, ỐNG SIZE 11",DAIM,780000,Nhật Bản / Việt Nam,"Hoa tươi, Cây cảnh & Hạt giống",780000,0,0
891629,Pin Sạc Đa Năng Power Plus AAA 700mAh Energizer NH12 RP2,Energizer,169000,Nhật Bản,Pin và dụng cụ sạc pin,169000,0,0
193109559,"Pin đại sạc Beston chuẩn 1.5V 6000mWh - cổng sạc USB Type C - Pin cỡ D dùng cho đèn pin, bếp ga, thiết bị công nghiệp",BESTON,159000,Trung Quốc,Pin và dụng cụ sạc pin,159000,0,0
97924113,Đồng Hồ Báo Thức Dạ Quang Deli - Khung Thép Không Gỉ - 9024,Deli,169000,Trung Quốc,Đồng hồ,304200,135200,44
142013586,Công Tơ Điện Tử Wifi Thông Minh 1 Pha - Bộ Theo Dõi Tiêu Thụ Điện Năng Thông Minh Vconnex - Hàng Chính Hãng,Vconnex,1127000,Việt Nam,Thiết bị điều khiển thông minh,1223000,96000,8
67865283,Ổ cắm xoay 90º Điện Quang ĐQ ESK RT 63 (6 lỗ 3 chấu),Điện Quang,89400,Việt Nam,"Ổ cắm, ổn áp, biến áp",111628,22228,20
129953317,"Xe đẩy hàng gấp gọn 4 bánh 120kg sàn thép nhập khẩu FUJIHOME SH150 - bánh xe chống ồn, Chính hãng bảo hành 1 năm",Fujihome,572300,Trung Quốc,Xe đẩy hàng,890000,317700,36
4942021,"Thang nhôm gấp 4 đoạn SUMIKA SK604 (chữ A - 2.35m, chữ I - 4.7m), 14 tư thế sử dụng, tải trọng 150kg, làm từ hợp kim nhôm cao cấp, khóa chốt tự động",Sumika,1310000,Trung Quốc,Thang nhôm,1900000,590000,31
41715390,Máy bắn đinh ghim đa năng Milliken,Milliken Tampe,200000,,,200000,0,0
45360988,"Bộ dây 20 kẹp ảnh, kẹp hình có đèn led trang trí nhà cửa (cổng sạc USB) - vàng ",OEM,85000,Việt Nam,,85000,0,0
10677222,Nệm Gấp 3 Pe Hàn Quốc ( 1m2x2mx3cm) Nhiều Màu Giao Ngẫu Nhiên,Happy,150000,,Nệm và phụ kiện,150000,0,0
57774896,Túi Đựng Bình Giữ Nhiệt Siêu Lớn Kèm Dây Đeo,OEM,35000,Trung Quốc,Phụ kiện nhà bếp,35000,0,0
110564196,Giá Lưới Lọc Thức Ăn Thừa Mifan - Túi Lọc Rác Bồn Rửa Chén Bát - Khung nhựa ABS chất lượng cao,Mifan,25000,Trung Quốc,Phụ kiện nhà bếp,40000,15000,38
131187017,Kệ Giày Thông Minh Giá Để Giày Hiện Đại Thương Hiệu IGA - GP159,IGA,540000,Việt Nam,Nội thất phòng khách,540000,0,0
274848217,Bộ Chuông Cảm Biến Chống Trộm Thông Minh - Hàng chính hãng ,PaKaSa,29000,Trung Quốc,Bảo vệ nhà cửa,58000,29000,50
29938359,Bật lửa khò cao cấp AM365,OEM,99000,Việt Nam,"Bếp nướng, vỉ nướng",99000,0,0
274807644,"Đèn Led ốp trần Rạng Đông, Đèn ốp nổi ban công [Tròn/Vuông",Rạng Đông,170000,Việt Nam,Đèn trần,170000,0,0
273915494,Cốc nhựa 2 lớp hình khủng long Elmich EL8332OL dung tích 480ml,Elmich,157000,Trung Quốc,"Ly, cốc & phụ kiện ly",350000,193000,55
51500414,GIÁ TREO QUẦN ÁO CHỮ A GỖ ĐA NĂNG 2 TẦNG SIZE 1M - AHAN 2F 1M,MW Furniture,569050,,Phụ kiện giặt ủi,599000,29950,5
188379989,Cốc Giữ Nhiệt Coffeeholic Teement Inox 304 Dung Tích 510ml Cao Cấp Kiểu Dáng Hàn Quốc Cầm Tay Sang Trọng- Hàng Chính Hãng,TEEMENT,150000,Trung Quốc,Bình/ Ly giữ nhiệt,150000,0,0
273181769,"Đệm ngồi bệt, nệm lót ghế tròn văn phòng họa tiết hoa văn nhiều mẫu vải bố canvas size lớn 40x40cm",TIDO,59500,Việt Nam,Nội thất phòng khách,70000,10500,15
264015994,"Cây Lau Nhà Thông Minh Hợp Kim Cao Cấp, Chổi Lau Nhà 360 Độ Lau Sạch Vắt Khô DAMAS CT2 - Bản Lau To Giúp Lau Sạch Nhanh Chóng, Khớp Xoay 180 Độ Linh Hoạt - Tự Động Gấp Gọn Tiện Lợi, Tích Hợp Thanh Lược Chải Làm Sạch Bông Lau Dễ Dàng Mà Không Cần Động Tay",Damas,390000,Trung Quốc,Dụng cụ lau nhà,390000,0,0
134419302,"Combo 8 móc dán tường chịu lực inox 304 có sẵn keo dán Hobby Home Decor 4545-2 không rỉ sét dán được gạch men, kính",Hobby Home Decor,85000,Trung Quốc,Phụ kiện giặt ủi,109000,24000,22
10326771,Chảo Gang Hai Tay Cầm La Gourmet Nitrigan NTGW347688 (32cm),La gourmet®,1139050,Trung Quốc,Nồi và chảo,1799000,659950,37
253390302,Bình Giữ Nhiệt Lock&Lock 480ml Symphony Tumbler LHC6150 nắp bật chỉ 1 tay cầm p3hstore,LocknLock,249000,Trung Quốc,Bình/ Ly giữ nhiệt,472000,223000,47
64988886,Bình giữ nhiệt Lock&amp;Lock Flat nắp gỗ 400ml - LHC4227WHT - Màu,LocknLock,293700,Trung Quốc,Bình/ Ly giữ nhiệt,534000,240300,45
58802220,Xe đẩy hàng 4 bánh MINGWEI tải trọng 200 kg gấp gọn ,MINGWEI,595000,Trung Quốc,Xe đẩy hàng,600000,5000,1
13044266,Đèn đọc sách gắn đầu giường RB LIGHTING,RB LIGHTING,270000,,,270000,0,0
182547783,Bông lau thay thế Bộ cây lau nhà 360 độ lồng giặt và vắt tích hợp Scotch Brite 3M Lấy sạch tóc,3M,72000,Việt Nam,Dụng cụ lau nhà,83000,11000,13
247326482,"Cây lau kính thông minh OKwife Glass N02 chổi lau kính đa năng 2 đầu trong 1, cán tăng giảm chiều dài",Kitimop,199000,Trung Quốc,Dụng cụ lau nhà,285000,86000,30
58298207,TỦ ĐỰNG THUỐC Y TẾ GIA ĐÌNH 3 TẦNG ( giao mầu ngẫu nhiên),HBH,190000,Trung Quốc,Phụ kiện phòng ngủ,190000,0,0
275212521,"Phích vuông thái 2.3L, Phích mini giữ nhiệt tiện lợi, Phích đá giữ nhiệt lên đến 8h - Nhựa Việt Nhật - Hàng Việt Nam",Việt Nhật,89000,Việt Nam,Dụng cụ chứa đựng thực phẩm,160000,71000,44
124658706,Bộ máng đèn Philips LED Batten BN012C G2,Philips,157200,Trung Quốc,Bóng và linh kiện đèn,238800,81600,34
169703063,"Chổi Quét Trần Nhà Có Cán Điều Chỉnh Độ Dài / Chổi Quét Mạng Nhện, Lau Chùi Bụi Bẩn Trên Cao Tiện Dụng PaKaSa - Hàng Chính Hãng",PaKaSa,59000,Việt Nam,Dụng cụ lau nhà,118000,59000,50
273743556,"Ghế Công Thái Học Điều Chỉnh Tư Thế Dành Cho Bé, Ghế Chống Gù Lưng Định Hình Cột Sống Ghế Điều Chỉnh Tư Thế Dobody Giảm Đau Mỏi Lưng Định Hình Cột Sống Điều Chỉnh Dáng Ngồi Chống Gù Chống Cong Vẹo Cột Sống - Giao Màu Ngẫu Nhiên",fofaHome,85000,Việt Nam,"Nội thất phòng học, làm việc",120000,35000,29
273332585,"Đèn Ngủ HUTA Light For Life G3 Chao Vuông Độc Đáo Vingtage, Decor Trang Trí Phòng Ngủ, Điều Chỉnh Độ Sáng, Bóng Led Sáng Vàng Tiết Kiệm Điện",HUTA Light For Life,266750,Trung Quốc,Đèn ngủ,275000,8250,3
51509701,GIÁ TREO QUẦN ÁO CHỮ A GỖ ĐA NĂNG 1 TẦNG SIZE 1M - AHAN 1F 1M,MW Furniture,522500,Việt Nam,Phụ kiện giặt ủi,550000,27500,5
271079083,Bình giữ nhiệt La Fonte 350ml - 002349,La Fonte,153000,Trung Quốc,Bình/ Ly giữ nhiệt,305000,152000,50
270303853,"Ghế Gác Chân Công Thái Học Điều Chỉnh 6 Cấp Độ Chiều Cao Thích Hợp Văn Phòng Làm Việc Học Tập, Ghế Kê Chân Chỉnh Dáng Ngồi Tốt Cho Sức Khỏe Cột Sống Giảm Đau Lưng Bảo Hành 90 Ngày",Office Chill,175000,Trung Quốc/Hàn Quốc/Mỹ/Thái Lan/Nhật Bản (tùy vào đợt hàng),"Nội thất phòng học, làm việc",199000,24000,12
35928141,"Combo 40 móc nhôm treo quần áo chắc chắn, tiện lợi, đa năng và cao cấp tiết kiệm không gian",OEM,69090,,Phụ kiện giặt ủi,69090,0,0
59238496,"Combo 02 Set đũa sợi thủy tinh TH kháng khuẩn, chịu nhiệt Shikisai - Nội địa Nhật Bản (10 đôi/set)",Tanaka,47999,Nhật Bản,"Đũa, muỗng, nĩa",47999,0,0
195955729,Bộ Bình Trà Thủy Tinh Kèm 4 Ly Lưới Lọc Inox 304 Không Gỉ Tiện Lợi - Hàng Chính Hãng,lilahome,79000,Trung Quốc,"Bình, ly uống trà và phụ kiện",99000,20000,20
271064495,Bình giữ nhiệt thể thao 709ml Lafonte 011013-WHI,La Fonte,244000,Trung Quốc,Bình/ Ly giữ nhiệt,478000,234000,49
196567078,Bộ Thanh Treo Rèm - Đầy Đủ Phụ Kiện - Chắc Chắn Chịu Lực Tốt Độ Bền Cao,MODERO,79000,Việt Nam,Nội thất phòng khách,89000,10000,11
274415047,"Đèn pin laser 303 siêu sáng gồm pin, sạc và khóa - Đèn lazer 303 tia Xanh lá - Hàng chính hãng",TiMa.lala,146000,Trung Quốc,,159000,13000,8
268453893,Dụng Cụ Thông Tắc Đường Ống Thép Không Gỉ - Eco Magic Snake 60cm và 160cm,EcoClean ,60000,China,Dụng cụ vệ sinh,60000,0,0
273384942,Đèn đường năng lượng mặt trời Vạn Năng Solar 300w,Vạn Năng Solar,1150000,Trung Quốc,Đèn ngoài trời,1150000,0,0
148812174,"Thìa, Muỗng Inox 316L Cao Cấp, Sản Phẩm Cao Cấp Và Sang Trọng Số 1 - KT: 16.7x3.3cm",Jodily StarHome,50000,Nhật Bản,"Đũa, muỗng, nĩa",50000,0,0
144507255,"Bàn chải chà sàn nhà tắm bằng cước siêu sạch Scotch Brite 3M - Đa năng, tay cầm nhựa cao cấp, dễ dàng thay thế lớp cước, không gây trầy xước 5300",ScotchBrite,42000,Việt Nam,Dụng cụ vệ sinh,51000,9000,18
274598313,"CỐNG THOÁT NƯỚC LẮP GHÉP ECO-Drain ID 80x35x500: Tải trọng 1.5 tấn, thoát nước nhanh, dễ lắp đặt và bảo trì, giảm lắng",ECO TECH,190000,Trung Quốc,Bể bơi và phụ kiện,250000,60000,24
66529072,Vòi nước vòi phun nước rửa xe tưới cây tăng áp thông minh đầu đồng 206587 kèm cút và đai,OEM,50122,Việt Nam,Dụng cụ làm vườn,50122,0,0
275271655,Giỏ Đựng Đồ Rửa Chén Bát Silicon Treo Bồn Rửa Bát 2 ngăn cao cấp,smatayoko,34000,China,Phụ kiện nhà bếp,34000,0,0
186883733,"Khay Làm Đá Bằng Nhựa 33 Viên Tròn Cao Cấp, Khuôn Làm Thạch Thông Minh Có Nắp Đậy - Chính hãng MINIIN (Giao màu ngẫu nhiên)",MINIIN,19000,Trung Quốc,Phụ kiện nhà bếp,29000,10000,34
55580718,"Bộ 3 Nồi Inox 304 Đáy Từ 5 Đáy Nagakawa NAG1352 (16cm, 20cm, 24cm) - Hàng Chính Hãng",Nagakawa,1235000,Trung Quốc,Nồi và chảo,1890000,655000,35
251243800,Tượng phật địa tạng vương bồ tát bằng gỗ bách xanh thơm nức kt cao 15×9×8cm ,DAICAT,499000,Việt Nam,Vật phẩm phong thủy,499000,0,0
114105978,Keo Vá Tường Chống Thấm LKB 250gr - Trám Trét Vết Nứt Khe Hở Tường - Chống Mốc Ẩm Làm Sạch Tường - Mifan Hàng Chính Hãng,LKB,29000,Trung Quốc,,35000,6000,17
199727619,Chổi quét nhà Sweepy ETM974 - Màu xanh,Sweepy,71500,Trung Quốc,Dụng cụ lau nhà,129000,57500,45
273971682,Hộp Inox 304 Trữ Đồ Tủ Lạnh Có Nắp Đậy,NAVIVU,20000,Trung Quốc,Dụng cụ chứa đựng thực phẩm,20000,0,0
56801184,Thảm chùi chân chất liệu cotton FMV7 Mollis 40 x 62 cm,Mollis,108000,Việt Nam,Phụ kiện nhà tắm,151000,43000,28
185051474,"Khung hoa hồng leo MONROVIA, ống thép bọc nhựa, nhiều size phù hợp hoa giấy, cây cảnh",Monrovia,230000,Mỹ / Trung Quốc,"Hoa tươi, Cây cảnh & Hạt giống",230000,0,0
173088409,"ĐẾ KÊ BÁT HƯƠNG GỖ HƯƠNG .ĐẾ CHO BÁT 9,10,11,12,14,16,18CM",THÁNG THÁNG THUẬN,175000,Việt Nam,,175000,0,0
271438161,Đôn Chậu Cây Cảnh Có Bánh Xe Cỡ Lớn 35Cm Thích Hợp Đặt Chậu Cây Trong Nhà Thuận Tiện Di Chuyển Màu Vàng,ANKAN,84000,Việt Nam,Ngoại thất sân vườn,149000,65000,44
79691104,Bộ Hộp Cơm Giữ Nhiệt Văn Phòng Cao Cấp Cắm Điện inox 3 tầng - Chính Hãng,miDoctor,204000,China / Vietnam,Bộ hộp cơm và phụ kiện,300000,96000,32
77279311,"Bộ 2 Đôi Đũa Nấu Bằng Gỗ Nhãn Tự Nhiên - VAGOO - Làm Thủ Công Chống Thấm, Chống Ẩm Mốc, An Toàn Cho Sức Khoẻ",Vagoo,69000,Việt Nam,"Đũa, muỗng, nĩa",69000,0,0
13158001,Combo 50 đinh 3 chân treo khung ảnh không cần khoan tường,OEM,34900,,Phụ kiện nhà bếp,34900,0,0
34180303,"Bếp Nướng Than Hoa, Than Củi Vuông - Rainy Cao Cấp - Hàng Chính Hãng",Rainy,156450,Việt Nam,"Bếp nướng, vỉ nướng",156450,0,0
271064497,Bình giữ nhiệt Lafonte 180718 500ml,La Fonte,102000,Trung Quốc,Bình/ Ly giữ nhiệt,220000,118000,54
275364154,"Kệ chén bát đĩa 2 - 3 tầng INOX 304 cao cấp sơn đen tĩnh điện kèm khay ráo nước, giá kệ úp bát khô ráo trên bàn bếp gọn gàng, sạch sẽ, kệ đa năng tiết kiệm không gian - Hàng cao cấp",Anh Lam Store,340000,Việt Nam,,400000,60000,15
203477253,Kệ Dao Đũa Nhà Bếp Đa Năng - Kệ Dao Đũa Thìa Dán Tường Không Khoan Đục,pehouse,249000,Việt Nam / Đài Loan,,400000,151000,38
167501197,Thau nhựa gấp gọn tiện dụng Henrysa - Chính hãng HENRYSA,HENRYSA Bạn của mọi nhà,65000,Trung Quốc,Dụng cụ chứa đựng thực phẩm,95000,30000,32
73576296,Gối Cao Su Liên Á Contour,Liên Á,270000,Việt Nam,"Gối, ruột gối, vỏ gối",270000,0,0
189264051,"Dù che mưa, Dù che nắng kính lái Ô Tô, Vải dù 2 lớp - Hàng chính hãng NIKITA",Nikita,139000,Hàn Quốc / Trung Quốc,"Áo mưa, ô dù và phụ kiện đi mưa",199000,60000,30
164924067,"Đèn Pha Philips LED BVP150 G2 - Công Suất 10W, 20W, 30W, 50W, 70W",Philips,251600,Trung Quốc,Đèn ngoài trời,387000,135400,35
55882240,Ghế xoay nhân viên lưng lưới Hòa phát GL119N,Hòa Phát,1030000,Việt Nam,"Nội thất phòng học, làm việc",1030000,0,0
46172285,Cây treo quần áo 3 chân 8 nhánh treo bằng gỗ cao su,Viet Home Decor,380000,Việt Nam,Phụ kiện giặt ủi,380000,0,0
129137119,BÌNH ĐÁ 1 LÍT GIỮ NHIỆT - HÀNG CHÍNH HÃNG,thermal bottle,37000,Việt Nam,Bình/ Ly giữ nhiệt,37000,0,0
275246947,Nệm Ngủ Trải Sàn Xuất Nhật 1m / 1m2 / 1m4 / 1m6 / 1m8 Có Thể Gấp Gọn Dễ Di Chuyển Tặng Kèm Drap Nệm,FUKOJI,399000,Việt Nam,Nệm và phụ kiện,500000,101000,20
275737218,Bộ móc áo trơn 5 chiếc Elmich EL0274,Elmich,73100,Trung Quốc,Phụ kiện giặt ủi,150000,76900,51
271064536,Bình đựng thực phẩm giữ nhiệt 500ml LaFonte 011044-RED,La Fonte,237000,Trung Quốc,Bình/ Ly giữ nhiệt,480000,243000,51
54349761,"Ấm đun nước cao cấp, bằng Inox, 7,5 lít, có còi, chính hãng Zebra (Classic - 113550)",Zebra,899000,Thái Lan,,899000,0,0
87651491,Quần đi mưa chống nước bền bỉ RANDO,Rando,150000,Việt Nam,"Áo mưa, ô dù và phụ kiện đi mưa",150000,0,0
64992089,Nệm Bông Ép K-Bedding MTP 120x198x9cm (Giao màu ngẫu nhiên),K-Bedding,2125000,Việt Nam,Nệm và phụ kiện,2500000,375000,15
47461891,Bộ 6 vỉ (12 viên pin) pin Kiềm Alkaline Panasonic AA LR6T/2B-Hàng chính hãng,Panasonic,169000,Thái Lan,Pin và dụng cụ sạc pin,169000,0,0
100407581,Ống Cắm Dao Kéo Nhà Bếp INOX SUS304 Có Khay Chứa Nước - OENON,OENON,195000,Trung Quốc,"Dao, kéo và phụ kiện",350000,155000,44
57754753,Dụng cụ bấm lỗ dây nịt cầm tay - HENRYSA,HENRYSA Bạn của mọi nhà,89000,Trung Quốc,Dụng cụ sửa chữa nhà cửa,150000,61000,41
152882085,Màng Bọc Thực Phẩm Ringo ST612SC,RINGO,295000,Việt Nam,Phụ kiện nhà bếp,295000,0,0
93093881,Nệm cao su non Thắng lợi gấp 3 đủ size dày 10cm,Nệm Thắng Lợi,1250000,Việt Nam,Nệm và phụ kiện,1250000,0,0
138488646,Combo 4 Khay Đá 144 Viên Tặng Kèm Xẻng Và Hộp Đựng Bằng Nhựa Cao Cấp - PaKaSa,PaKaSa,116620,Trung Quốc,Phụ kiện nhà bếp,190000,73380,39
194498258,Chốt khóa số cửa ngang dùng mật khẩu tiện dụng Hobby home decor LCK,Hobby Home Decor,155000,Trung Quốc,Bảo vệ nhà cửa,155000,0,0
275501860,Bộ vỏ chăn ga gối cotton tici notag Lidaco cotton đũi trơn dày decor phòng ngủ vintage đủ mọi cỡ nệm,LIDACO,269000,Trung Quốc/ Việt Nam(SM078),,400000,131000,33
275815588,"Bàn Tròn Mặt Gỗ MDF 48X48X30cm Chân Nhựa Chắc Chắn Làm Bàn Ăn, Bàn Làm Việc Đa Năng, Ngồi Học, Decor Phòng Siêu Đẹp",Gosashi,72000,Việt Nam,"Nội thất phòng học, làm việc",86000,14000,16
9795280,Vòi rửa chén lạnh đôi SUS 304 Yamato CLI16,YAMATO,311000,,Phụ kiện nhà bếp,590000,279000,47
275320577,"Cây Cọ Toilet ,Bàn Chải Nhà Tắm kokOmega Hàn Quốc, Tay Cầm Tiện Dụng Chà Sạch Vết Bẩn, Sử Dụng Cho Nhà Tắm, Bồn Rửa",KokOmega,37050,Việt Nam,Dụng cụ vệ sinh,39000,1950,5
203765578,"Áo mưa Dây Kéo Kháng Giọt Bắn ROFA, RANDO Chính Hãng, Có Kiếng Che Mặt, Bít Sườn 1 Người Mặc, Nhẹ Nhàng, Thời Trang",Rando,150000,Việt Nam,,150000,0,0
32879419,Bộ Cây Lau Nhà Xoay Tay 360 Độ Lock & Lock MOP-L003 - 2 Bông Lau,LocknLock,779000,Trung Quốc,Dụng cụ lau nhà,1250000,471000,38
105232946,Gối cao su non Memory Foam Pillow công nghệ Nhật Bản - Giúp Ngủ Nhanh - Chống thoái hoá đốt sống cổ - HT SYS - [ Hàng Nhập Khẩu,HT SYS,215000,Nhật Bản,"Gối, ruột gối, vỏ gối",215000,0,0
92680994,Hộp Qụet Bật Lửa Khò Gas 444 Thiết Kế Nhỏ Gọn Cao Cấp ( Giao Màu Ngẫu Nhiên ),OEM,49000,Hong Kong,"Bếp nướng, vỉ nướng",49000,0,0
275467052,"ROGTZ - Máy Phát Hiện Nghe Trộm C308 - Phát Hiện Camera, Định Vị GPS Hiệu Quả, Phát Hiện Đa Tần Số, Công Nghệ Quét Hồng Ngoại, Cảnh Báo Thông Minh, Pin 500mAh Hoạt Động Bền Bỉ, Thiết Kế Hiện Đại - Hàng Chính Hãng",ROGTZ,179550,Trung Quốc,Bảo vệ nhà cửa,189000,9450,5
275075668,Đèn Bàn Học Led Bảo Vệ Mắt Chống Cận Làm Việc - Đọc Sách - Học Tập - Thân Đèn Uốn Cong Tiện Lợi - Linh Hoạt Điều Chỉnh Góc Độ & Vùng Sáng - Hàng Chính Hãng,Gro-Fa,136000,Trung Quốc,Đèn học và đọc sách,136000,0,0
54348404,"Ấm đun nước cao cấp, bằng Inox, 2,5 lít, có còi, chính hãng Zebra (Classic - 113518)",Zebra,726000,Thái Lan,,726000,0,0
275057514,"Bình Thủy Tinh Có Bộ Lọc Xác Trà, Thảo Dược, Cafe 450ml Bằng Inox Không Gỉ  - Hàng Chính Hãng",PaKaSa,130900,Trung Quốc,,200000,69100,35
655370,Đèn Pin Tay Cầm Cỡ Lớn Sunhouse SHE-4111 - Đen Đỏ (1W),Sunhouse,60000,Trung Quốc,,94000,34000,36
253238381,"Tấm chắn dầu mỡ, nước bắn trong nhà bếp Dandihome inox 304 cao cấp",DandiHome,186960,Trung Quốc,Phụ kiện nhà bếp,205000,18040,9
274169165,"Kính chống bụi, chống tia UV, chống trầy xước cao cấp Honeywell S200A",Honeywell,80000,Mỹ,Bảo hộ lao động,80000,0,0
54583763,Đèn bàn học Rạng Đông chính hãng RD RL 38 LED,Rạng Đông,209000,,Đèn học và đọc sách,209000,0,0
135220125,"Đầu Vòi Tăng Áp Lực Nước 7 Chế Độ Rửa Xe , Tưới Cây Sân Vườn .. - PaKaSa",PaKaSa,39000,Trung Quốc,Dụng cụ làm vườn,78000,39000,50
271959445,"Đầu vòi rửa bát tăng áp đồng thau inox 304 cao cấp Mifan - 3 Chế độ phun cực mạnh, xoay 360 - Sử dụng cho bồn rửa chén bát",Mifan,135000,China / Vietnam,Phụ kiện nhà bếp,200000,65000,33
271807876,Màn tuyn 1m8x2m trơn trắng,Màn tuyn Dệt 10/10,129600,Việt Nam,Phụ kiện phòng ngủ,129600,0,0
275428127,Lọ chiết nước hoa du lịch 5ml GROFA ( Giao màu ngẫu nhiên),Gro-Fa,29000,Trung Quốc,Phụ kiện nhà tắm,29000,0,0
72281774,Đèn Bàn Học LED USB Di Động Cao Cấp - Đèn Làm Việc Sang Trọng Để Bàn Chống Chói Mắt Bảo Vệ Mắt - Có Thể Gập Hai Chỗ – 03 Chế Độ Ánh Sáng Vàng Bảo Vệ Mắt Chống Cận - Hàng Chính Hãng - VinBuy,VinBuy,195000,Việt Nam / Trung Quốc,Đèn học và đọc sách,300000,105000,35
253188848,"Áo Mưa Bisur Dây Kéo - Thương hiệu Rando, chính hãng, cao cấp - APNS-33",Rando,382000,Việt Nam,"Áo mưa, ô dù và phụ kiện đi mưa",382000,0,0
78633940,Máy Sấy Và Khử Trùng Giày Xiaomi Youpin SOTHING DSHJ-S-1904 có hẹn giờ,Xiaomi,259000,Trung Quốc,Phụ kiện giặt ủi,269000,10000,4
56834315,Khăn Tắm Cotton Organic BM3Q Mollis 90 x 100 cm,Mollis,200000,Việt Nam,Khăn,271000,71000,26
263401289,Bộ Chuyển Đổi Máy Khoan Thành Máy Cưa Điện Cầm Tay Kèm 3 Lưỡi Cưa Gỗ Kim Loại Nhựa ( Lắp Được Khoan Pin Và Khoan Điện),OEM,119000,Việt Nam / Đài Loan,"Đá cắt, que hàn, cưa & lưỡi cưa",119000,0,0
184495640,Hạt giống rau thơm sả ( é trắng ) RADO 189 Rạng Đông - Gói 5gram,Rạng Đông,8820,Việt Nam,"Hoa tươi, Cây cảnh & Hạt giống",9000,180,2
162366804,Đồng Hồ Dán Tường DIY VINAVU Sang Trọng Cỡ Siêu Lớn Nhiều Mẫu,OEM,190000,Trung Quốc,Đồng hồ,190000,0,0
203767359,"Áo Mưa Cánh Dơi Vải Dù Cao Cấp PC Vải BEST Kiếng, GIÁ SỈ, RANDO Chính Hãng, Có Kiếng Phủ Đèn Xe, Bền Bỉ Không Thấm Nước",Rando,339000,Việt Nam,,339000,0,0
54607545,"Nồi cán dài chống dính đáy từ Tefal So Chef 18cm, dùng cho mọi loại bếp- Hàng chính hãng",Tefal,395120,Pháp,Nồi và chảo,679000,283880,42
198100951,"Thảm Chùi Chân, Lau Chân Siêu Hút Nước, Mạ Vàng Sang Trọng, Chống Trượt, An Toàn Khi Sử Dụng",Friday's,200000,Trung Quốc,Phụ kiện nhà tắm,200000,0,0
69243802,"Ghế xếp văn phòng lưng cao, ghế phòng chờ  VIMOS",VIMOS,455000,Việt Nam,Nội thất phòng ngủ,455000,0,0
31672125,GIẤY THƠM BOUNCE  (160 Tờ x 1 hộp ),Bounce,185000,Mỹ,Phụ kiện giặt ủi,185000,0,0
74191022,Đồng hồ treo tường RHYTHM - JAPAN  CMG817NR04 (Kích thước 32.0 x 4.8cm),Rhythm,968000,Trung Quốc,Đồng hồ,968000,0,0
274691766,"Bộ lau nhà Plus 2 ngăn tự vắt, cây lau nhà xoay 360 độ giúp lau sàn làm sạch",PEAFLO,235000,Hàn Quốc / Trung Quốc,Dụng cụ lau nhà,325000,90000,28
56498914,Dụng cụ tách vỏ sò IN18,Song An Eco,55000,Việt Nam,Phụ kiện nhà bếp,55000,0,0
132018116,"Bình hút tài lộc phong thủy vẽ vàng 24k,  gốm sứ Bát Tràng cao cấp, trang trí phòng khách ",Bát Tràng,370000,Việt Nam,Lọ hoa & hoa trang trí,370000,0,0
686899,Bộ 2 Hộp Thủy Tinh Glasslock 400ml Và Túi Giữ Nhiệt Lunch Set 2,GlassLock,194000,Hàn Quốc,Bộ hộp cơm và phụ kiện,319000,125000,39
276174579,"Combo Bao Khăn Giấy Hít Bụi LET-GREEN, 20 Miếng/Bao",Let-green,71400,Việt Nam,Dụng cụ lau nhà,84000,12600,15
43168879,Khoá số DL12 công nghệ Singapore dành cho Tủ Locker gỗ (Locker & Lock),Locker & Lock,650000,Trung Quốc,Bảo vệ nhà cửa,650000,0,0
129911417,"Bộ 6 Lọ Đựng Gia Vị Chất Liệu Thủy Tinh Kèm Đế Xoay 360 Tiện Lợi- TẠo Sang Trọng, Gọn Gàng Cho Căn Bếp - Hàng Chính Hãng MINIIN",MINIIN,208050,Taiwan,Dụng cụ chứa đựng thực phẩm,219000,10950,5
214920805,"Bóng Đèn Led Trụ HUTA Đuôi E27, Tiết Kiệm Điện, Chống Nước, Ánh Sáng Trắng/Vàng, Công Suất 20w/30w, Chiếu Sáng Ngoài Trời, Sân Vườn",HUTA Light For Life,52000,Trung Quốc,Bóng và linh kiện đèn,52000,0,0
